das forderten sie bei der ersten zossener runde am dienstagabend . dass die politiker der stadt dafür verständnis haben , ist löblich .	mit dem treffen im rathaus ist auch ein dialog zwischen den generationen angestoßen .	other
ärgerlich ist es trotzdem .	aberwitzig dazu .	und
dass die beiden geladenen jugendlichen im laufe des abends immer weniger zu wort kamen , war sicher keine böse absicht ,	ärgerlich ist es .	other
es entbehrt nicht der komik , wenn sich drei erwachsene - karola andrae ( bürgerbündnis/fdp ) , susanne michler ( cdu ) und joachim zanow ( spd ) - darüber streiten , was jugendliche wollen und brauchen , ohne auf die idee zu kommen , sie selbst zu fragen .	das , obwohl sie ihnen gegenüber sitzen .	und
es entbehrt nicht der komik ,	sich drei erwachsene - karola andrae ( bürgerbündnis/fdp ) , susanne michler ( cdu ) und joachim zanow ( spd ) - darüber streiten , was jugendliche wollen und brauchen , ohne auf die idee zu kommen , sie selbst zu fragen .	wenn
und das ,	sie ihnen gegenüber sitzen .	other
es entbehrt nicht der komik , wenn sich drei erwachsene - karola andrae ( bürgerbündnis/fdp ) , susanne michler ( cdu ) und joachim zanow ( spd ) - darüber streiten , was jugendliche wollen und brauchen , ohne auf die idee zu kommen , sie selbst zu fragen . und das , obwohl sie ihnen gegenüber sitzen .	die jugendlichen wurden zum bloßen feigenblatt degradiert .	other
nicht über hätten die politiker reden sollen .	mit ihnen	sondern
in der gruppe können sie sich hoffentlich mehr gehör verschaffen .	vielleicht finden auch vertreter von pds und gewerbeverein ihren weg ins rathaus .	dann
dann werden auch mehr jugendliche eingeladen .	vielleicht klappt es bei der nächsten runde anfang 2002 .	dann
wenn das so ist ,	müssen konzepte zur landesgartenschau jetzt mit nachvollziehbaren zahlen untersetzt werden .	other
warum wird im landwirtschaftsministerium ein städtischer eigenanteil an laga-vorhaben mit 7,5 millionen mark berechnet ,	im laga-finanzierungskonzept der stadt gerade 5 millionen mark hineingeschrieben wurden ?	other
eben dieses verwirrspiel ist es , was diejenigen in sorge treibt , die jetzt die landesgartenschau konkreter hinterfragen .	auch sie wollen , dass in rathenow eine gut vorbereitete laga 2006 stattfindet .	denn
der bürgermeister hat die finanzsituation , in der sich die stadt befindet als " schwierig aber beherrschbar " bezeichnet .	wenn das so ist , dann müssen konzepte zur landesgartenschau jetzt mit nachvollziehbaren zahlen untersetzt werden .	other
warum wird im landwirtschaftsministerium ein städtischer eigenanteil an laga-vorhaben mit 7,5 millionen mark berechnet , während im laga-finanzierungskonzept der stadt gerade 5 millionen mark hineingeschrieben wurden ?	eben dieses verwirrspiel ist es , was diejenigen in sorge treibt , die jetzt die landesgartenschau konkreter hinterfragen .	other
was sie erwartet , chaos und eventuell das aus .	sie sich nicht rechtzeitig auf die euroeinführung vorbereiten :	wenn
dort erfahren die dienstleister , was sie erwartet , wenn sie sich nicht rechtzeitig auf die euroeinführung vorbereiten : chaos und eventuell das aus . der umrechnungskurs für den euro steht fest . daran darf nicht gerüttelt werden .	zu beachten ist - neben der eindeutigen auszeichnung der waren - auch die " richtige " umrechnung von mark in euro .	denn
auf- und abgerundet wird zwei stellen hinter dem komma - nach kaufmännischem prinzip .	dies kann bei den gewerbetreibenden zu einnahmeverlusten führen .	other
dies kann jedoch bei den gewerbetreibenden zu einnahmeverlusten führen .	auch kleinvieh macht ja bekanntlich mist .	denn
denn zu beachten ist - neben der eindeutigen auszeichnung der waren - auch die " richtige " umrechnung von mark in euro . der umrechnungskurs für den euro steht fest . daran darf nicht gerüttelt werden . auf- und abgerundet wird zwei stellen hinter dem komma - nach kaufmännischem prinzip . dies kann jedoch bei den gewerbetreibenden zu einnahmeverlusten führen . denn auch kleinvieh macht ja bekanntlich mist .	gut beraten ist , wer sich schon rechtzeitig mit der rechnerei beschäftigt .	deshalb
unbegründete und panische preiserhöhungen vergraulen nur die kunden .	wer zu lange wartet , um sich mit den rechnereien zu beschäftigen , verliert bei der euroumstellung den Überblick .	doch
doch wer zu lange wartet , um sich mit den rechnereien zu beschäftigen , verliert bei der euroumstellung den Überblick .	riskiert damit das vertrauen seiner kunden .	und
tränen flossen gestern zum volkstrauertag auf dem friedhof von langen . noch mehr als 56 jahre nach dem ende des zweiten weltkriegs trauern menschen um den verlust eines geliebten mannes , vaters oder kindes .	mit dem krieg beschäftigte sich am sonnabend die kreissynode der evangelischen kirche .	auch
die stimmung hat sich gewandelt ,	klar ist , was vielen vorher klar war : " saubere chirurgische schnitte " gegen terroristen gibt es mit flächenbombardements nicht und selbst high-tech-bomben verfehlen oft genug ihr ziel .	other
" saubere chirurgische schnitte " gegen terroristen gibt es mit flächenbombardements nicht	selbst high-tech-bomben verfehlen oft genug ihr ziel .	und
alle , die krieg für notwendig halten , nehmen auch diese unschuldigen opfer in kauf .	sollten wir uns gerade am volkstrauertag erinnern können , wie es sich anfühlt , wenn das tote kind auf dem fernsehschirm nicht mehr " irgendein asiate " ist , sondern unser eigenes kind .	other
wie es sich anfühlt ,	das tote kind auf dem fernsehschirm nicht mehr " irgendein asiate " ist , sondern unser eigenes kind .	wenn
nicht mehr " irgendein asiate " ist ,	unser eigenes kind .	sondern
abgesehen von der in paretz herrschenden generellen ablehnung gegen den havelausbau	den damit verbundenen brückenneubau	und
zwar ist die umleitung laut bauherr nur 4,5 kilometer lang .	was machen die wanderer und radfahrer ?	other
zwar ist die umleitung laut bauherr nur 4,5 kilometer lang . aber was machen die wanderer und radfahrer ?	noch schlimmer - wie kommen die landwirte mit ihren traktoren ab mittwoch auf die felder jenseits des kanals ?	und
hier hat das wasserstraßenneubauamt versagt - ohne wenn und aber .	wofür die behörde nichts kann , ist der unglückliche zeitpunkt des baubeginns so kurz nach der wiedereröffnung des schlosses .	other
abgesehen von der in paretz herrschenden generellen ablehnung gegen den havelausbau und den damit verbundenen brückenneubau - die bürger quasi bis fünf minuten vor zwölf im regen stehen zu lassen , ist nicht zu fassen bei solch einem großprojekt .	zwar ist die umleitung laut bauherr nur 4,5 kilometer lang .	other
wofür die behörde jedoch nichts kann , ist der unglückliche zeitpunkt des baubeginns so kurz nach der wiedereröffnung des schlosses .	seit einem jahr ist klar , dass es nach der buga los geht .	other
anfangs hatte bürgermeister detlef lemke noch gehofft , nun bessere verhandlungskarten für den götzer beitritt zur groß-kreutzer großgemeinde zu haben .	machen die dortigen orte aus ihrer ablehnung keinen hehl .	other
dreht sich götz um	blickt nach emster-havel ,	und
sah es noch vor wenigen wochen düster um die zukunft der verwaltungseinheit aus , dürfte die schwächung des amtes groß kreutz durch die austrittswünsche zweier gemeinden emster-havel stärken .	anfangs hatte bürgermeister detlef lemke noch gehofft , nun bessere verhandlungskarten für den götzer beitritt zur groß-kreutzer großgemeinde zu haben .	other
für die austrittswilligen amtsgemeinden damsdorf und gollwitz freilich dürfte die groß-kreutzer problemlage keine folgen haben .	die hoffen , götz nun leichter im amt zu halten .	other
wurde dies als sieg verkauft .	der bundestag anfang juli den beschluss darüber fasste ,	als
erweist es sich als mogelpackung .	das gesamte paket an neuerungen zur familienförderung ab 2002 für die betroffenen überschaubar wird ,	other
selbst familien profitieren erst ab einem jahreseinkommen von 120_000 mark von dem neuen recht .	hatte das bundesverfassungsgericht eine entlastung ausdrücklich für alle familien gefordert .	other
den betroffenen bleibt nur , erneut vor gericht zu ziehen .	das dauert .	und
den betroffenen bleibt nur , erneut vor gericht zu ziehen . und das dauert .	die kinder werden älter und kosten immer mehr .	aber
zu jahresbeginn sorgte wochenlanges tauziehen um 30 mark mehr kindergeld für schlagzeilen .	als der bundestag anfang juli den beschluss darüber fasste , wurde dies als sieg verkauft .	other
als der bundestag anfang juli den beschluss darüber fasste , wurde dies als sieg verkauft .	jetzt , da das gesamte paket an neuerungen zur familienförderung ab 2002 für die betroffenen überschaubar wird , erweist es sich als mogelpackung .	other
gunnar lade ist unbequem , das steht außer frage .	diesmal ist das gut so .	doch
als einziger stadtverordneter zeigte er nämlich courage am montag in der sitzung des hauptausschusses ,	es um die abstimmung zum lang diskutierten schulthema ging und eine klare aussage gefordert war ,	als
es um die abstimmung zum lang diskutierten schulthema ging	eine klare aussage gefordert war ,	und
es scheint fast so , als wolle es sich kein abgeordneter mit denen , die da von entscheidungen betroffen sein könnten , verscherzen .	man mag es gunnar lade nicht verübeln , wenn er diese szenerie als " schmierentheater " bezeichnete .	other
man mag es gunnar lade daher nicht verübeln ,	er diese szenerie als " schmierentheater " bezeichnete .	wenn
man mag es gunnar lade daher nicht verübeln , wenn er diese szenerie als " schmierentheater " bezeichnete .	fest steht : kein lehrer verliert seinen job , kein schüler wird schlechter unterrichtet als vorher .	doch
wirklich betroffen könnten erzieher und technisches personal sein .	sollte es neben wirtschaftlichen und kapazitätsgründen um gute schulkonzepte gehen .	other
unpopuläre entscheidungen zu treffen ,	sich ein schlechtes gewissen einreden zu lassen .	other
wozu gibt es die ,	sie unbeachtet bleiben bei derart wichtigen entscheidungen ?	wenn
freilich , außenstehende haben gut reden .	wer sich wählen lässt , sollte die courage aufbringen , unpopuläre entscheidungen zu treffen , ohne sich ein schlechtes gewissen einreden zu lassen .	doch
als einziger stadtverordneter zeigte er nämlich courage am montag in der sitzung des hauptausschusses , als es um die abstimmung zum lang diskutierten schulthema ging und eine klare aussage gefordert war , die sonst offenbar niemand zu treffen wagte .	doch diesmal ist das gut so .	other
doch wer sich wählen lässt , sollte die courage aufbringen , unpopuläre entscheidungen zu treffen , ohne sich ein schlechtes gewissen einreden zu lassen .	, außenstehende haben gut reden .	other
bin laden hat amerika getroffen , die westliche welt herausgefordert	krieg ausgelöst	und
deutschland diskutiert : waren veronas tränen echt ?	johannes b. kerner gibt interviews über seine vermittlerrolle im ehekrieg , gegen die bushs medienauftritte alt aussehen .	und
es muss wohl mehr passieren ,	der boulevard sich von seinen schießbudenfiguren trennt .	other
sie sehen , lesen , kaufen	darüber reden wollen ,	und
werden wir damit leben müssen .	wir sie sehen , lesen , kaufen und darüber reden wollen ,	other
nunmehr soll eine kita öffnen ,	zwischen zehn und 15 prozent ( schon diese spanne ist ein zugeständnis ) der insgesamt betreuten mädchen und jungen in der einrichtung sind .	wenn
woher nehmen ) eine faire entscheidung ,	nicht stehlen ?	und
aus demokratischer sicht ( die mehrheit entscheidet ) und auch unter wirtschaftlichem aspekt ( woher nehmen und nicht stehlen ? ) eine faire entscheidung ,	die bei veränderten kinderzahlen jederzeit korrigierbar ist .	other
die verwaltung reagiert damit auf eine analyse , die sich vor allem mit der anzahl betreuter kinder zu den verschiedenen tageszeiten beschäftigt .	im löwenberger land steht eine Änderung der kita-Öffnungszeiten bevor .	other
mit den folgen müssen sich die verwaltungen vor ort herumplagen .	unpopuläre entscheidungen , die bis zur schließung führen , sind die folge .	other
bisher wurde ihr zustand zwar als nicht unproblematisch eingeschätzt ,	einen vergleich mit schwer gebeutelten neubaugebieten , wie etwa velten-süd , hätten kommunalpolitiker abgelehnt .	other
einen vergleich mit schwer gebeutelten neubaugebieten , wie etwa velten-süd , hätten kommunalpolitiker aber abgelehnt .	eine bürgerbefragung ergab , dass mehr als die hälfte der bewohner der mittelstadt schon über den wegzug nachgedacht hat .	other
dass es nach den notsignalen wieder zeichen der hoffnung gibt , dafür könnte das zis-programm sorgen .	das wird ohne ein mitwirken der mieter und vermieter in der mittelstadt nicht funktionieren .	aber
inzwischen hat sich die bücherstadt einen namen gemacht .	wird hoffentlich nicht mehr kleinzukriegen sein - trotz der pleite der landesentwicklungsgesellschaft ( leg ) und gelegentlichen jammerns in den eigenen reihen .	und
und wird hoffentlich nicht mehr kleinzukriegen sein -	der pleite der landesentwicklungsgesellschaft ( leg ) und gelegentlichen jammerns in den eigenen reihen .	other
mit dem gestrigen umwelttag ist ein zunächst ungewöhnlich scheinender schritt getan worden .	solche " ausrutscher " sind gewollt .	doch
doch lange nicht für alle .	schließlich stellen alte bücher für bestimmte zielgruppen einen magneten dar ,	other
schließlich stellen alte bücher zwar für bestimmte zielgruppen einen magneten dar ,	lange nicht für alle .	doch
zusatzangebote müssen her ,	was bietet sich da in der grünen waldstadt mehr an als die beschäftigung mit der natur ?	und
sich in puncto resonanz nicht selbst zu belügen ,	lieber etwas für mehr besucher zu tun .	sondern
hinzu kommt , dass es allemal besser ist , sich in puncto resonanz nicht selbst zu belügen , sondern lieber etwas für mehr besucher zu tun .	dass solche lügen kurze beine haben , musste die leg in diesem jahr erfahren .	denn
der pleite der landesentwicklungsgesellschaft ( leg )	gelegentlichen jammerns in den eigenen reihen .	und
doch solche " ausrutscher " sind gewollt .	stellen alte bücher zwar für bestimmte zielgruppen einen magneten dar , doch lange nicht für alle .	other
sie hatte vor ( ! ) der langen nacht der antiquare kühn die 2000er besucherzahlen in druck gegeben .	sich damit gehörig blamiert ...	und
inzwischen hat sich die bücherstadt einen namen gemacht .	es gibt gastronomie und bunkerführungen ebenso wie museen und diverse veranstaltungen .	other
zusatzangebote müssen her , und was bietet sich da in der grünen waldstadt mehr an als die beschäftigung mit der natur ?	hinzu kommt , dass es allemal besser ist , sich in puncto resonanz nicht selbst zu belügen , sondern lieber etwas für mehr besucher zu tun .	other
christian gildes wiederwahl als landrat war ein erfolg .	was dieser wirklich wert ist , zeigt sich erst im tagesgeschäft .	doch
doch was dieser wirklich wert ist , zeigt sich erst im tagesgeschäft .	das weiß gilde auch :	und
geht es nach gilde , bliebe das so .	fragt er sich , ob der kreistag das genauso sieht .	doch
doch fragt er sich , ob der kreistag das genauso sieht .	signalisiert er vorab , dass er durchaus einen anderen als seinen lieblingskandidaten zur wahl im kreistag vorschlagen würde .	deshalb
einerseits ist es vernünftig .	begibt sich gilde damit in die hände des kreistags .	other
im falle einer abstimmungs-niederlage würde er ebenso wie sein kandidat beschädigt .	ist es schlau , kritiker ins boot zu holen .	other
andererseits begibt sich gilde damit in die hände des kreistags .	der könnte gefallen daran finden , ihm einen unbequemen aufpasser an die seite zu stellen .	und
und der könnte gefallen daran finden , ihm einen unbequemen aufpasser an die seite zu stellen .	, was weitaus unangenehmer wäre , einen ehrgeizigen konkurrenten , der gilde - möglichst schnell - beerben will .	oder
der landrat hat die wahl gewonnen ,	sich auf seinen lorbeeren ausruhen - das kann er nicht .	doch
was insider längst wussten	die bürger dieser stadt seit langem ahnten	und
nicht einmal die vertreter der stadt in gesellschafterversammlung und aufsichtsrat wurden von der verwaltung ausreichend geschult .	legte die kämmerei , als für die vermögensverwaltung der stadt zuständige stelle , die hände in den schoß .	other
obendrein legte die kämmerei , als für die vermögensverwaltung der stadt zuständige stelle , die hände in den schoß .	das schlimmste ist , dass noch heute versucht wird , zu mauscheln .	aber
bürgermeister jochen wagner zieht sich auf die vertraulichkeit zurück .	erwarten die bürger nach diesem vertrauensbruch klare antworten darauf , welche konsequenzen aus diesem desaster gezogen wurden .	other
dabei erwarten die bürger nach diesem vertrauensbruch klare antworten darauf , welche konsequenzen aus diesem desaster gezogen wurden .	was bekommen sie zu hören ?	doch
sie sind schon seit jahren an klärwerke angeschlossen . die klärwerke beziehungsweise die druckleitungen wurden bereits von der gemeinde und damit von den steuern der bürger bezahlt .	warum sollen sie jetzt noch einmal klärbeiträge bezahlen , nur weil sie von einem klärwerk an ein anderes umgeleitet werden ?	also
die anderen wiederum haben sich zuerst zur solidargemeinschaft zweckverband zusammengeschlossen	die regeln bestimmt , denen sich nun auch die zu fügen haben , die später dazugekommen sind .	und
in sich schlüssig sind beide argumentationen .	die einen hatten glück , dass ihr bürgermeister cleverer oder schneller war als andere .	other
warum fand am mittwoch nicht ein einziger kränzliner den weg zur verbandsversammlung ?	der Ärger über klärbeiträge so gewaltig ist ,	wenn
die einen hatten eben glück , dass ihr bürgermeister cleverer oder schneller war als andere .	die anderen wiederum haben sich zuerst zur solidargemeinschaft zweckverband zusammengeschlossen und die regeln bestimmt , denen sich nun auch die zu fügen haben , die später dazugekommen sind .	other
die anderen wiederum haben sich zuerst zur solidargemeinschaft zweckverband zusammengeschlossen und die regeln bestimmt , denen sich nun auch die zu fügen haben , die später dazugekommen sind .	wie der streit ausgeht , entscheidet am ende wohl ein gericht .	other
wie der streit ausgeht , entscheidet am ende wohl ein gericht .	komisch ist nur : wenn der Ärger über klärbeiträge so gewaltig ist , warum fand am mittwoch nicht ein einziger kränzliner den weg zur verbandsversammlung ?	other
im benachbarten berlin hat es keinen anschlag mit milzbrand-erregern gegeben .	in bayern nicht .	auch
im benachbarten berlin hat es keinen anschlag mit milzbrand-erregern gegeben . in bayern auch nicht .	die bilder von männern in mondanzügen und atemschutzmasken haben durchaus etwas von ausnahmezustand , ja katastrophenalarm .	aber
aber die bilder von männern in mondanzügen und atemschutzmasken haben durchaus etwas von ausnahmezustand , ja katastrophenalarm .	ist panikmache unverantwortlich .	other
ein eingespieltes team von spezialisten hält ausrüstung und fachleute bereit ,	schnell und umfassend handeln können .	other
ist ihrem steten bemühen um vorbeugung zu danken - , wo die feuerwehr schon in der planung eines gebäudes mitwirkt .	im brandschutz	other
dass sie unter normalen umständen kaum in erscheinung treten , ist ihrem steten bemühen um vorbeugung zu danken - zum beispiel im brandschutz , wo die feuerwehr schon in der planung eines gebäudes mitwirkt .	sollte der zivilschutz verbessert werden .	other
sollten die rettungskräfte nicht das nachsehen haben .	landesweit die polizei aufgerüstet wird ,	wenn
wenn landesweit die polizei aufgerüstet wird , sollten die rettungskräfte nicht das nachsehen haben .	es doch einmal kein mieser scherz war .	other
die landwirtschaft stellt in brandenburg - noch immer einen wichtigen wirtschaftszweig dar , der darüber hinaus viele arbeits- und ausbildungsplätze schafft .	des hohen beschäftigungsrückgangs nach der wende -	other
die landwirtschaft stellt in brandenburg - trotz des hohen beschäftigungsrückgangs nach der wende - noch immer einen wichtigen wirtschaftszweig dar ,	der viele arbeits- und ausbildungsplätze schafft .	other
80 prozent der fläche brandenburgs wird nach angaben des landesamtes für agarwirtschaft derzeit landwirtschaftlich genutzt .	belebt der wirtschaftszweig den dörflichen raum .	other
darüber hinaus belebt der wirtschaftszweig den dörflichen raum .	in zeiten von bse müssen agrarwirte auch umdenken , sich auf neue extensive produktionsformen einlassen und andere vermarktungsmöglichkeiten erschließen .	other
darüber hinaus belebt der wirtschaftszweig den dörflichen raum .	in zeiten von bse müssen agrarwirte jedoch umdenken , sich auf neue extensive produktionsformen einlassen und andere vermarktungsmöglichkeiten erschließen .	auch
in zeiten von bse müssen agrarwirte jedoch auch umdenken , sich auf neue extensive produktionsformen einlassen	andere vermarktungsmöglichkeiten erschließen .	und
sollte die ausbildung stimmen .	das gelingt ,	other
mancher mag gar erbost darüber sein , die ereignisse in einem atemzuge zu lesen .	doch : was den leuten damals über den reichstagsbrand erzählt wurde , war lüge .	und
mancher mag gar erbost darüber sein , die ereignisse in einem atemzuge zu lesen .	und : was den leuten damals über den reichstagsbrand erzählt wurde , war lüge .	doch
" seid sensibler und aufmerksamer ,	wir können nicht sicher sein ... "	denn
wir können nicht sicher sein , dass unsere regierung im sinne des volkes handelt ,	der kanzler amerika gegenüber die uneingeschränkte solidarität deutschlands erklärt hat .	other
können wir denn alles glauben , was uns heute über den kampf gegen den terrorismus in dem asisatischen land gesagt wird ?	und doch : was den leuten damals über den reichstagsbrand erzählt wurde , üwar lüge .	denn
es war sicher nicht die letzte lobpreisung für hans-joachim giersberg .	dürfte ihm die ehrenbürgerwürde , die ihm potsdam gestern verlieh , wertvoller sein als mancher preis , der da noch kommen mag .	doch
doch dürfte ihm die ehrenbürgerwürde , die ihm potsdam gestern verlieh , wertvoller sein als mancher preis , der da noch kommen mag .	ist es die anerkennung dafür , dass der frühere generaldirektor der schlösserstiftung nicht allein von der sorge um die anvertrauten kunstschätze getrieben war ,	doch
ist es doch die anerkennung dafür , dass der frühere generaldirektor der schlösserstiftung nicht allein von der sorge um die anvertrauten kunstschätze getrieben war , sondern von der vision einer stadt , die durch diese kunst lebt .	stand giersberg nicht nur wie der fels in der brandung , als die kommerzialisierungswogen an die schlossmauern schlugen . sein stilles , aber nachhaltiges eintreten für die qualitäten der kulturlandschaft außerhalb seiner gärten , allzuoft als sichtachsen-fetischismus benörgelt , hat dazu beigetragen , die landeshauptstadt als gesamtkunstwerk erfahrbar zu machen . dafür hat ihm potsdam zu danken .	so
nicht allein von der sorge um die anvertrauten kunstschätze getrieben war ,	von der vision einer stadt , die durch diese kunst lebt .	sondern
so stand giersberg nicht nur wie der fels in der brandung ,	die kommerzialisierungswogen an die schlossmauern schlugen . sein stilles , aber nachhaltiges eintreten für die qualitäten der kulturlandschaft außerhalb seiner gärten , allzuoft als sichtachsen-fetischismus benörgelt , hat dazu beigetragen , die landeshauptstadt als gesamtkunstwerk erfahrbar zu machen . dafür hat ihm potsdam zu danken .	als
mit seinem ja zu den schlössernächten übersprang er am ende sogar den schatten des nur ängstlichen bewahrers , als der er lange galt .	endet mit giersberg eine Ära .	other
wechselte der wie eine mumie auf der bank sitzende ukrainische coach noch zwei ähnliche leichtgewichte ein .	den tapfer kämpfenden gästen der ausgleich gelungen war ,	other
könnte der um ehre und reputation kämpfenden mannschaft von rudi völler der weg zur weltmeisterschaft endgültig verbaut sein .	die drei knirpse von anbeginn wirbeln ,	wenn
je kleiner die kicker daherkommen ,	größer wird der gegner geredet .	other
die fußball-kleinmacht vom dnepr steht kurz davor , das scheinbar mit einem dauerabonnement für die wm ausgestattete team in der schwarz-weißen kluft und eine ganze nation in das tal der tränen zu treiben .	haben die deutschen nationalkicker einen " rudi riese " auf der bank und einen franz beckenbauer mit heißem draht zum fußballgott .	other
in falkensee ist derzeit vor allem eines - bürgermeister-wahlkampf .	da kündigt jürgen bigalke ( spd ) an , die mit finanzdezernentin ruth schulz besetzte stelle der 1. beigeordneten ( stellvertretende bürgermeisterin ) nicht öffentlich ausschreiben und dies noch vor dem 11. november bestätigen lassen zu wollen .	also
die mit finanzdezernentin ruth schulz besetzte stelle der 1. beigeordneten ( stellvertretende bürgermeisterin ) nicht öffentlich ausschreiben	dies noch vor dem 11. november bestätigen lassen zu wollen .	und
da kündigt jürgen bigalke ( spd ) also an , die mit finanzdezernentin ruth schulz besetzte stelle der 1. beigeordneten ( stellvertretende bürgermeisterin ) nicht öffentlich ausschreiben und dies noch vor dem 11. november bestätigen lassen zu wollen .	acht weitere jahre könnte die sozialdemokratin amtieren - selbst dann , wenn der rathauschef abgewählt werden und damit die ein-stimmen-mehrheit der spd/fdp-zählgemeinschaft in der stadtverordenten-versammlung zusammenbrechen sollte .	dann
acht weitere jahre könnte die sozialdemokratin dann amtieren - selbst	, der rathauschef abgewählt werden und damit die ein-stimmen-mehrheit der spd/fdp-zählgemeinschaft in der stadtverordenten-versammlung zusammenbrechen sollte .	other
wenn der rathauschef abgewählt werden	damit die ein-stimmen-mehrheit der spd/fdp-zählgemeinschaft in der stadtverordenten-versammlung zusammenbrechen sollte .	und
wenn der rathauschef abgewählt werden	und die ein-stimmen-mehrheit der spd/fdp-zählgemeinschaft in der stadtverordenten-versammlung zusammenbrechen sollte .	other
grüne und christdemokraten wären schlechte herausforderer , würden sie dieses ansinnen nicht als " schlechten stil " und als " erbhof-sicherung " zerreißen ,	die sache rechtlich in ordnung ginge .	other
sind bigalke und die seinen wirklich so naiv	denken , diese wichtige personalie geräuschlos durchzukriegen ?	und
sind bigalke und die seinen wirklich so naiv und denken , diese wichtige personalie geräuschlos durchzukriegen ?	handeln sie kaltschnäuzig nach dem motto : augen zu und durch ?	oder
der bürgermeister hat aus einer mücke einen elefanten gemacht -	ihn in den porzellanladen gejagt .	und
westernreiter kennen sich aus mit dem Überwinden von stock und stein .	dürften sie kein problem haben , die zurzeit noch katastrophale parkfläche an der graf-von-lindenau-halle in kauf zu nehmen .	also
sie machen das auch ,	wir uns dessen bewusst sind , dass hier böser sarkasmus die zeilen prägt ,	other
dass hier böser sarkasmus die zeilen prägt ,	der seine berechtigung in absehbarer zeit verloren hat .	aber
die hatte auch gar keine andere wahl ,	das juristische tauziehen mit dem bauausführenden betrieb verloren worden war .	other
der aber seine berechtigung in absehbarer zeit verloren hat .	am parkplatz , der von anfang an ein Ärgernis war , tut sich etwas .	other
war schon in der zeitung zu lesen , dass geld lockergemacht worden ist ,	ist nun von einem ersten ergebnis zu berichten .	so
was blieb , war die total misslungene abstellfläche , bei der sich zu spät herausstellte , dass die vielen besucher für die halle einfach zu viel waren .	war schon in der zeitung zu lesen , dass geld lockergemacht worden ist , so ist nun von einem ersten ergebnis zu berichten .	other
beim csi , dem hochdotierten reitturnier im januar , sollen die nägel köpfe haben .	bis dahin müssen sich alle dreinfügen - wie die westernreiter und ihre fans .	other
was hat den spd-chef geritten , einen derart beleidigenden brief über die ob-kandidatin tiemann in die welt zu schicken ?	ihm seine fraktion die zustimmung dafür verweigerte ,	other
süffisant , lächelnd und mit feinem florett hätte er ihr aufs brot schmieren können , dass sie wohl ein wenig vorschnell gewesen sei , als sie den markt noch vor weihnachten zuschütten wollte .	nein : stuckenbrok nahm den krummsäbel und schlug zu .	aber
stuckenbrok nahm den krummsäbel	schlug zu .	und
mit den sprüchen vom " rft - reichtum für tiemann " schafft er es nicht einmal die lufthoheit über die stammtische zu bekommen .	auch die seitenhiebe auf die " einzige örtliche tageszeitung " , die sich von havel-berlusconi tiemann domestizieren lasse und mit ins loch steige , wird ihm niemand abnehmen .	und
die sich von havel-berlusconi tiemann domestizieren lasse	mit ins loch steige , wird ihm niemand abnehmen .	und
und auch die seitenhiebe auf die " einzige örtliche tageszeitung " , die sich von havel-berlusconi tiemann domestizieren lasse und mit ins loch steige , wird ihm niemand abnehmen .	ist hinlänglich bekannt , dass es keine partei intensiver versucht hat als die spd - über welchen umweg auch immer - einfluss auf kritische berichterstattung zu nehmen .	doch
rational ist gerd stuckenbroks verbaler schnellschuss mit tendenz zur beleidigung nicht zu erklären .	, der genosse bekommt muffensausen , weil ihm die felle davonschwimmen ...	other
der genosse bekommt muffensausen ,	ihm die felle davonschwimmen ...	weil
nicht alles einfach so hinnehmen , was behördenmitarbeiter vorgeben , lautet ihre devise .	das ist gut so .	und
und das ist gut so .	die ansicht der denkmalpfleger ist kaum nachzuvollziehen .	denn
historische orte in ihrem urzustand zu belassen	wieder so herzustellen .	oder
da kommt ein innerstädtischer straßenbau oft gerade recht ,	kann man dabei auch löchrige asphaltpisten oder buckliges pflaster durch ordentlich verlegte passende pflastersteine ersetzen .	doch
da kommt ein innerstädtischer straßenbau oft gerade recht , kann man doch dabei auch löchrige asphaltpisten oder buckliges pflaster durch ordentlich verlegte passende pflastersteine ersetzen .	warum soll nun direkt an der zehdenicker kirche , wo das kopfsteinpflaster derzeit zugegebenermaßen sehr hügelig ist und laute rollgeräusche verursacht , ein asphaltbelag drauf ?	aber
sehr hügelig ist	laute rollgeräusche verursacht , ein asphaltbelag drauf ?	und
dass sich die zehdenicker dagegen wehren , ist mehr als verständlich .	müssen sie sich bewusst sein , dass so ein " kampf " nur durchzustehen ist , wenn sich alle einig sind .	other
so ein " kampf " nur durchzustehen ist ,	sich alle einig sind .	wenn
kann sehr lange dauern	das bauvorhaben verzögern .	und
dass man nicht mehr wie ein luchs auf der lauer liegen muss ,	die Öffnungszeiten auch einzuhalten .	other
was nützt ihnen die verlagerung an einen neuen standort mit den längeren Öffnungszeiten ,	sie schlecht zu fuß sind ?	wenn
besonders berufstätige , dürfen nun aufatmen .	die es auch noch am sonnabend an ihre schließfächer drängt ,	other
alles an einem ort zu haben - papierwaren kann man kaufen , postalisches abwickeln - ist ja tatsächlich kundenfreundlich .	noch mehr freut es natürlich , dass man nicht mehr wie ein luchs auf der lauer liegen muss , um die Öffnungszeiten auch einzuhalten .	other
noch mehr freut es natürlich , dass man nicht mehr wie ein luchs auf der lauer liegen muss , um die Öffnungszeiten auch einzuhalten .	besonders berufstätige , die es z. b. auch noch am sonnabend an ihre schließfächer drängt , dürfen nun aufatmen .	other
zu danken ist dies natürlich in erster linie den engagierten mitarbeitern und der investitionsfreudigkeit des konzerns .	auch gransees stadtväter trugen als unbürokratische wegbereiter ihr scherflein zum erfolg bei .	aber
aber auch gransees stadtväter trugen als unbürokratische wegbereiter ihr scherflein zum erfolg bei .	das macht mut .	und
optimistisch in die zukunft blicken	weitere investitionen anvisieren .	und
natürlich hoffen die mitarbeiter , dass sich die millionenschweren investionen bezahlt machen .	wer weiß , vielleicht steht frische milch aus gransee eines tages tatsächlich auf dem tisch von einheimischen .	und
und wer weiß , vielleicht steht frische milch aus gransee eines tages tatsächlich auf dem tisch von einheimischen .	ob dies mehr als ein wunschtraum ist , bleibt abzuwarten .	aber
ob dies aber mehr als ein wunschtraum ist , bleibt abzuwarten .	letztlich liegt die entscheidung über den erfolg eines produkts einzig und allein beim verbraucher .	denn
mehrere beteiligte firmen erhielten kein geld , ausstehende bauabschnitte konnten nicht fortgeführt werden .	führt ein zwangsverwalter das zepter .	other
wurde jetzt auch die weiße stadt in das eu-förderprogramm " zukunft im stadtteil " aufgenommen .	der ursprünglichen planung	other
firmenchef klaus kesting gelang ein großer coup .	noch vor dem endgültigen abzug der russischen armee 1994 begann er mit dem umbau von kasernen zu sozial- und eigentumswohnungen .	other
für investitionen in die infrastruktur der einstigen heinkel-siedlung gibt es keine müde mark .	die folgen sind stagnation und stellenweise schon verwahrlosung .	other
wenn man nicht dem förderzweck gemäß handelt , haben die geldgeber das recht ( im interesse der steuerzahler die pflicht ) , ihre beiträge zurückzufordern .	man seinen betrieb nicht aufrecht hält ,	wenn
, haben die geldgeber das recht ( im interesse der steuerzahler die pflicht ) , ihre beiträge zurückzufordern .	man nicht dem förderzweck gemäß handelt	wenn
wenn man seinen betrieb nicht aufrecht hält , wenn man nicht dem förderzweck gemäß handelt , haben die geldgeber das recht ( im interesse der steuerzahler die pflicht ) , ihre beiträge zurückzufordern .	ein unterschied zu 1999 besteht .	aber
nun muss der cdu-wirtschaftsminister regeln , was seine heutigen koalitionspartner einst einbrockten :	noch immer ist nicht erwiesen , ob das fx-center , wie man es einst haben wollte , überhaupt funktionieren kann .	denn
damals brauchte man nach dem konkurs der ersten betreibergesellschaft monate ,	man mit artemedia einen nachfolger gefunden hatte .	other
ein unterschied zu 1999 aber besteht .	damals , mitten im landtagswahlkampf , war das fx-center chefsache der spd-staatskanzlei .	other
damals , mitten im landtagswahlkampf , war das fx-center chefsache der spd-staatskanzlei .	nun muss der cdu-wirtschaftsminister regeln , was seine heutigen koalitionspartner einst einbrockten :	other
gefährliche krankheitserreger eingetütet	ohne jede ehrfurcht vor menschlichem leben in einen tödlichen kreislauf geschickt werden .	und
vielleicht stehen sie ganz in der nähe rum ,	die briefe geöffnet werden und schrecken verbreiten , zu aufwändigen sicherheitsmaßnahmen zwingen .	wenn
die briefe geöffnet werden	schrecken verbreiten , zu aufwändigen sicherheitsmaßnahmen zwingen .	und
zumindest gemischte gefühle beschleichen auch die mitarbeiter des hennigsdorfer briefzentrums ,	sie briefe mit merkwürdigen anschriften , arabischen lettern oder fühlbar ungewöhnlichem inhalt feststellen .	wenn
abgelten kann er sie nicht ,	andere menschen in angst zu versetzen , das ist ein übles verbrechen .	denn
angst zu schüren ist die makabere " coole " absicht von trittbrettfahrern in diesen wochen .	denen muss es offenbar imponieren , dass in amerika gefährliche krankheitserreger eingetütet und ohne jede ehrfurcht vor menschlichem leben in einen tödlichen kreislauf geschickt werden .	other
da ist manfred meske zuzustimmen .	das land bereits im vorigen jahr mehr als 30 millionen mark in die sanierung des azv steckte .	other
beispiel ist der lehniner trink- und abwasserzweckverband , der jetzt schuldenfrei ist .	hatten die fünf zugehörigen gemeinden über jahre hohe , die haushalte schmerzende umlagen gezahlt .	other
jetzt ruhig blut bewahren	die bürgerinitiative klug mit einzubinden	und
das land hat mit seinem schuldenmanagement bereits vielen verbänden aus der misere geholfen .	beispiel ist der lehniner trink- und abwasserzweckverband , der jetzt schuldenfrei ist .	other
die wiederum sollte nun gleichfalls nicht aus dem bauch heraus agieren .	jetzt ruhig blut bewahren und die bürgerinitiative klug mit einzubinden , ist gebot der stunde .	other
die wiederum sollte nun gleichfalls nicht aus dem bauch heraus agieren .	bleibt abzuwarten , ob das jahrelange ringen um hohe millionen-schulden bald vor dem abschluss steht .	other
noch 29 tage ,	ist unsere geliebte d-mark keine offizielle währung mehr .	dann
mit der einführung des euros wird vieles teurer ,	pfennig- zu centbeträge sicher eher auf- statt abgerundet werden .	weil
weil pfennig- zu centbeträge sicher eher auf-	abgerundet werden .	other
da ist es um so erfreulicher , wenn ausnahmsweise etwas billiger wird .	noch dazu etwas , dass jeder braucht .	und
manche geschäftsleute werden vor der währungsumstellung noch schnell ihre ware verteuern ,	sie sich besser umrechnen lässt .	other
da ist es um so erfreulicher ,	ausnahmsweise etwas billiger wird .	wenn
die gasversorgung zehdenick wird den erdgaspreis senken .	ein vierköpfiger haushalt spart im kommenden jahr immerhin etwa 57,50 mark gegenüber 2001 .	dann
beim strom ließ sich die preissteigerung zwar nicht stabil halten .	der neuen Ökosteuer-stufe	other
beim strom ließ sich die preissteigerung wegen der neuen Ökosteuer-stufe zwar nicht stabil halten .	die stadtwerke haben auf den preis ausschließlich die Ökosteuererhöhung umgelegt .	other
die stadtwerke haben aber auf den preis ausschließlich die Ökosteuererhöhung umgelegt .	preiserhöhungen des zulieferers blieben unberücksichtigt .	other
preise runter	wenigstens nur das nötigste umlegen .	oder
dass dessen direktor schellnhuber kürzlich um ein haar ins ausland abgewandert wäre .	dass er geblieben ist , hat vordergründig mit mehr geld fürs institut zu tun :	doch
die stadt hat was .	was ?	aber
die nähe zur landesregierung ist ein standortvorteil , wie das tauziehen um schellnhuber beweist .	kaum eine region deutschlands hat ein derart dichtes netz von kooperierenden wissenschaftseinrichtungen zu bieten - der erfolg des interdisziplinären helmholtz-instituts für die schulung an supercomputern spricht bände .	und
nun kommt es darauf an , sich nicht auf einsteins lorbeeren auszuruhen .	weiche standortfaktoren allein reichen nicht aus .	denn
nach dem fall von masar-i-scharif sollen sich vor den friseurläden der stadt lange schlangen von männern gebildet haben , die sich ihre bärte abrasieren lassen wollten , hieß es gestern .	sei aus den restaurants laute musik zu hören gewesen , was unter dem regime der taliban verboten war .	auch
sollen sich vor den friseurläden der stadt lange schlangen von männern gebildet haben , die sich ihre bärte abrasieren lassen wollten , hieß es gestern .	dem fall von masar-i-scharif	other
kann man sich ein rasches vorrücken der nordallianz auf kabul eigentlich nur wünschen .	solchen nachrichten	other
bei solchen nachrichten kann man sich ein rasches vorrücken der nordallianz auf kabul eigentlich nur wünschen .	da nicht die politischen bedenken wären , dass der krieg gegen die taliban sich zu einem neuen bürgerkrieg ausweiten könnte .	wenn
sollte die nordallianz sich als herrscher afghanistans gebärden ,	wäre nichts gewonnen .	dann
nicht nur teil der lösung ,	auch teil des problems .	sondern
die nordallianz zu bremsen	deren alleinige machtübernahme zu verhindern .	und
ist die eigene mehrheit der koalition gefährdet .	es auch in der spd abweichler gibt ,	other
konnte der kosovo-krieg noch mit dem kampf für die menschenrechte in europa begründete werden , geht es nun um die militärische solidarität mit den usa in einem weit entfernten dritte-welt-land .	die kritiker wissen auch , dass sie weder den krieg in afghanistan stoppen noch eine deutsche beteiligung daran verhindern können .	doch
konnte der kosovo-krieg noch mit dem kampf für die menschenrechte in europa begründete werden , geht es nun um die militärische solidarität mit den usa in einem weit entfernten dritte-welt-land .	doch die kritiker wissen , dass sie weder den krieg in afghanistan stoppen noch eine deutsche beteiligung daran verhindern können .	auch
doch die kritiker wissen auch , dass sie weder den krieg in afghanistan stoppen	eine deutsche beteiligung daran verhindern können .	other
doch die kritiker wissen auch , dass sie weder den krieg in afghanistan stoppen noch eine deutsche beteiligung daran verhindern können .	sie können die rot-grüne regierung in eine schwere krise treiben .	aber
rund 15 grüne bundestagsabgeordnete haben erhebliche zweifel , ob sie der bereitstellung von bundeswehrsoldaten für den anti-terror-kampf zustimmen können .	da es auch in der spd abweichler gibt , ist die eigene mehrheit der koalition gefährdet .	other
30 jahre zählt das neubauwohngebiet ,	etwa jeder dritte kiewitter ist von anfang an dabei	und
nicht nur die unlust , die oft kleinen räume im alter noch gegen größere zu tauschen .	gibt es hier wohnungen am wasser , die man auch nach sanierung heute noch bezahlen kann	other
vielmehr gibt es hier wohnungen am wasser , die man auch nach sanierung heute noch bezahlen kann	für die treuen kiezbewohner sind Überlegungen schwer nachvollziehbar , die hochhäuser abzustocken oder gar ganz zu schleifen	other
die hochhäuser abzustocken	gar ganz zu schleifen	oder
nur in der berliner vorstadt wohnen vergleichbar viele leute so nah an der havel ,	seien es die hohen auflagen von denkmalpflegern , sei es der drang nach maximalgewinn bei den neuen eigentümern : wegen hoher mieten weichen große teile der stammbevölkerung den besser verdienenden .	doch
weichen große teile der stammbevölkerung den besser verdienenden .	hoher mieten	other
wegen hoher mieten weichen große teile der stammbevölkerung den besser verdienenden .	am kiewitt pflegt man bodenständigkeit	other
die platte hat sich inwendig erneuert	äußerlich farbe aufgelegt	und
die platte hat sich inwendig erneuert und äußerlich farbe aufgelegt .	nun sollte man im umfeld nachziehen - die treuhand mit der ufergaststätte etwa .	other
ein wahlausgang , der beide wahlgegner zufrieden stellt - das ist eine seltenheit !	am gestrigen abend zeigten sich beide bürgermeisterkandidaten durchaus zufrieden .	doch
elisabeth herzog-von_der_heide ( spd ) freute sich über das wahlergebnis , das ihr mehr als 60 prozent einbrachte ,	hans-jürgen akuloff ( pds ) war 's zufrieden , dass er das bisher beste ergebnis für die pds einfuhr .	und
das war natürlich um so leichter ,	es diesmal nur einen gegenkandidaten gab .	other
die parteienlandschaft in luckenwalde ist natürlich nach wie vor breiter gefächert .	brauchen jetzt weder spd- noch pds-anhänger einen höhenflug zu bekommen .	deshalb
der gestrige wahlausgang ist das persönliche ergebnis der beiden kandidaten ,	sie einen dritten im ersten wahlgang ausgestochen hatten .	other
nach der ersten " skat-runde "	hat in der zweiten " mau-mau-runde " herz-dame herzog gestochen .	dann
kein überraschendes , auch kein wahnsinnig überragendes ,	ein deutliches stichwahl-ergebnis .	aber
die extreme spannung war sowieso raus ,	die erste wahl hatte sowieso die vorentscheidung gebracht , die jetzt durch die stichwahl nur noch bestätigt wurde .	denn
dieser anspruch besteht jetzt ( noch ) nicht .	würden dafür die rund 100 kilometer langen rad- und skatewege im süden des kreises lange nicht reichen .	other
zum einen würden dafür die rund 100 kilometer langen rad- und skatewege im süden des kreises lange nicht reichen .	müsste hinter solch einem angebot die gesamte region in aller konsequenz stehen .	other
sollte wirklich einmal inline-skaten den kreis teltow-fläming über die grenzen hinaus anziehend machen ,	müsste man vorher die gesamte infrastruktur darauf ausrichten , um diese sportart als eine touristische attraktion anzubieten .	so
außerdem müsste hinter solch einem angebot die gesamte region in aller konsequenz stehen .	sollte wirklich einmal inline-skaten den kreis teltow-fläming über die grenzen hinaus anziehend machen , so müsste man vorher die gesamte infrastruktur darauf ausrichten , um diese sportart als eine touristische attraktion anzubieten .	denn
denn sollte wirklich einmal inline-skaten den kreis teltow-fläming über die grenzen hinaus anziehend machen ,	so müsste man die gesamte infrastruktur darauf ausrichten , um diese sportart als eine touristische attraktion anzubieten .	other
ist das nur gut .	damit auch gleichzeitig den touristen mehr wege erschlossen werden ,	wenn
wenn damit auch gleichzeitig den touristen mehr wege erschlossen werden , ist das nur gut .	es wäre wenigstens erst einmal ein anfang .	denn
die sind längst überfällig	würden den einwohnern endlich den alltag leichter machen .	und
sondern das wie , der druck auf abgeordnete , die kein regierungsamt haben und ihr gewissen deshalb auch nicht in den vorzimmern der macht abgeben können .	nicht , dass beide eine mehrheit für ihre koalition suchten , war das Ärgerliche in den vergangenen tagen ,	sondern
kein regierungsamt haben	ihr gewissen deshalb auch nicht in den vorzimmern der macht abgeben können .	und
kein regierungsamt haben	und ihr gewissen auch nicht in den vorzimmern der macht abgeben können .	deshalb
gut , dass wir eine rot-grüne koalition haben , stoßseufzen viele hinter vorgehaltener hand ,	würde die republik brennen .	other
gut , dass wir eine rot-grüne koalition haben , stoßseufzen viele hinter vorgehaltener hand , andernfalls würde die republik brennen .	das ist das dilemma der regierenden .	und
mit amerika schon kritische solidarität übten ,	schröder noch schmidt wegen dessen amerikahörigkeit beschimpfte und fischer in mutlangen gegen die nachrüstung demonstrierte .	als
schröder noch schmidt beschimpfte	dessen amerikahörigkeit	other
schröder noch schmidt wegen dessen amerikahörigkeit beschimpfte	fischer in mutlangen gegen die nachrüstung demonstrierte .	und
es stimmt schon , schmidt , kohl und genscher hätten in washington sehr viel genauer nach strategie und zielen fragen können ,	sie nicht vor der eigenen vergangenheit weglaufen mussten .	other
und des gewissens , möchte man mit blick auf schröder und fischer hinzufügen .	verrat , hat talleyrand einmal zynisch bemerkt , ist nur eine frage des datums .	und
bekanntlich ist vertrauen gut und kontrolle besser .	manchmal hilft es auch , mit dem bürger einfach zu reden .	aber
das hatte die bauaufsicht nicht getan ,	sie ihren unbegründeten baustopp-bescheid gegen einen grundbesitzer abschickte .	als
das hatte die bauaufsicht nicht getan , als sie ihren unbegründeten baustopp-bescheid gegen einen grundbesitzer abschickte .	stiefelte ein mitarbeiter auf das grundstück , knipste , was ihm verdächtig vorkam und löste dann den bürokratischen gang der dinge aus .	other
statt dessen stiefelte ein mitarbeiter auf das grundstück , knipste , was ihm verdächtig vorkam	und löste den bürokratischen gang der dinge aus .	dann
statt dessen stiefelte ein mitarbeiter auf das grundstück , knipste , was ihm verdächtig vorkam	löste dann den bürokratischen gang der dinge aus .	und
dass das hinterhofgebäude zwar reichlich baubedürftig aussieht ,	dort seit der wende kein handschlag mehr getan wurde ,	other
dass das hinterhofgebäude zwar reichlich baubedürftig aussieht , dort aber seit der wende kein handschlag mehr getan wurde ,	gar keine baustelle existiert , die gestoppt werden könnte .	other
nun gut , fehler kommen vor und die bauaufsicht hat den bescheid inzwischen zurückgenommen .	es geht um mehr als einen einzelfall .	doch
natürlich sind kontrollen notwendig .	viele bürger hätten mehr davon , wenn in den amtsstuben etwas mehr vertrauen waltete und die überschüssige kraft in die schnelle bearbeitung von bauanträgen gesteckt würde .	aber
viele bürger hätten aber mehr davon ,	in den amtsstuben etwas mehr vertrauen waltete und die überschüssige kraft in die schnelle bearbeitung von bauanträgen gesteckt würde .	wenn
in den amtsstuben etwas mehr vertrauen waltete	die überschüssige kraft in die schnelle bearbeitung von bauanträgen gesteckt würde .	und
dass das hinterhofgebäude zwar reichlich baubedürftig aussieht , dort aber seit der wende kein handschlag mehr getan wurde , folglich gar keine baustelle existiert , die gestoppt werden könnte .	nun gut , fehler kommen vor und die bauaufsicht hat den bescheid inzwischen zurückgenommen .	other
nur der einfluss von außen kann diesen poker beenden .	so schielen die israelis nach washington , an dessen tropf sie militärisch und wirtschaftlich hängen , die palästinenser zur europäischen union und zu den arabischen staaten , von deren unterstützung sie abhängen .	und
nur der einfluss von außen kann diesen poker beenden .	und schielen die israelis nach washington , an dessen tropf sie militärisch und wirtschaftlich hängen , die palästinenser zur europäischen union und zu den arabischen staaten , von deren unterstützung sie abhängen .	so
die folge ist oft genug eine polarisierung auch bei den potenziellen schiedsrichtern .	zu weihnachten waren sich us-amerikaner und europäer einig : das vom israelischen premier verhängte reiseverbot für arafat zur christmette nach bethlehem war unnötig und unangemessen .	other
das vom israelischen premier verhängte reiseverbot für arafat zur christmette nach bethlehem war unnötig und unangemessen .	punktsieg für den palästinenserchef im duell der alten haudegen .	also
und so schielen die israelis nach washington , an dessen tropf sie militärisch und wirtschaftlich hängen , die palästinenser zur europäischen union und zu den arabischen staaten , von deren unterstützung sie abhängen .	die folge ist oft genug eine polarisierung auch bei den potenziellen schiedsrichtern .	other
punktsieg also für den palästinenserchef im duell der alten haudegen .	bis zum nächsten schachzug .	other
das ganze leben ist ein quiz	wir sind nur die kandidaten ,	und
der anteil politischer sendungen am programm hat weiter abgenommen	ein ende ist nicht in sicht .	und
dass private anbieter , die sich nur durch werbung finanzieren , publikumswirksame unterhaltungssendungen in den vordergrund stellen , ist verständlich .	dass die gebührenfinanzierten programme ihren auftrag - die fernsehpublizistische und politische grundversorgung zu sichern - zunehmend ignorieren , ist mehr als bedenklich .	aber
dass aber die gebührenfinanzierten programme ihren auftrag - die fernsehpublizistische und politische grundversorgung zu sichern - zunehmend ignorieren , ist mehr als bedenklich .	das öffentliche mandat fordert eine gesunde mischung von unterhaltung und information .	denn
kann das nicht darüber hinwegtäuschen , dass die spaßgesellschaft längst auch beim öffentlich-rechtlichen rundfunk den ton angibt .	an katastrophen-tagen sondersendungen wie der " ard-brennpunkt " laufen ,	wenn
das ganze leben ist ein quiz und wir sind nur die kandidaten , sang bereits vor zehn jahren hape kerkeling .	nun bestätigt eine studie den weitsichtigen entertainer :	other
sie beantwortet aber nicht die frage , weshalb man eine " krisenpartei " in der bundesregierung braucht .	so schonungslose offenheit ist an sich bemerkenswert ,	other
so könnte in rostock in der tat wieder einmal ein klassischer kompromiss herauskommen - gegen den militär-einsatz und für die weitere beteiligung an der bundesregierung .	die vorzeichen nicht trügen ,	other
entweder die basis stützt den minister	sie stürzt ihn .	other
es kann nicht sein , dass die basis gewissermaßen die moral pachtet	ihn die realpolitische schmutzarbeit machen lässt .	und
sicher waren früheren " schlachten " ( o-ton schröder ) um kreissitz , mbs , verkehrsbetriebe oder verwaltungsbauten auch keine einfachen ,	gemessen an den kommenden wirken sie wie sandkastenspiele .	aber
jetzt kämpft man nicht mehr um meinungen ,	um geld und die freiräume , wenigstens noch etwas gestalten zu können .	sondern
klaffen nun immer neue millionenlöcher , die kaum noch zu stopfen sind .	im sozialetat ,	other
die wiederwahl von landrat schröder galt schon vor der gestrigen wahl als sicher .	neben den nur wenig bestrittenen qualitäten des verwaltungschefs dürfte auch ein anderer punkt den ausschlag gegeben dafür haben , dass sich kein konkurrent um den posten gefunden hat :	other
zu nennen ist ihr einsatz für den wiederaufbau des rheinsberger schlosstheaters , die entdeckung preußischer komponisten , das zeitgenössische musiktheater und den musikstandort rheinsberg .	hinterlässt das votum der jury einen faden nachgeschmack : für all das hat sich in rheinsberg nämlich auch siegfried matthus eingesetzt , komponist und leiter der dortigen kammeroper .	other
dennoch hinterlässt das votum der jury einen faden nachgeschmack :	für all das hat sich in rheinsberg auch siegfried matthus eingesetzt , komponist und leiter der dortigen kammeroper .	other
hätte man beide bedenken müssen .	der preis schon nach rheinsberg gehen soll ,	wenn
wenn der preis schon nach rheinsberg gehen soll , hätte man beide bedenken müssen .	sie in herzlicher feindschaft verbunden sind .	other
zumal sie in herzlicher feindschaft verbunden sind .	statt zur versöhnung aufzurufen , könnte diese entscheidung die wunden noch tiefer reißen .	doch
könnte diese entscheidung die wunden noch tiefer reißen .	zur versöhnung aufzurufen ,	other
jetzt steht es fest , das "goldene-oktober"-wetter geht seinem ende entgegen .	mit der ungemütlichen jahreszeit nehmen die gefahren auf den straßen zu , darauf weist die polizei mit nachdruck hin .	auch
die mitarbeiter der verkehrsunfallbekämpfung im schutzbereich teltow-fläming haben eine reihe von hinweisen für eine gute fahrt durch den herbst parat .	sie wissen , dass jetzt wieder verstärkt wild die straßen überquert und plötzlich vor fahrzeugen auftauchen kann .	other
wild die straßen überquert	plötzlich vor fahrzeugen auftauchen kann .	und
auch bei laub-"matten" auf der fahrbahn ist vorsicht angesagt	, vor allem , sie durch regen oder tau nass sind .	wenn
auch bei laub-"matten" auf der fahrbahn ist vorsicht angesagt , vor allem , wenn sie durch regen oder tau nass sind .	besonders in kurven kann zu schnelles fahren dazu führen , dass fahrzeuge ausbrechen .	dann
die geschwindigkeit zu drosseln	den sichtverhältnissen anzupassen .	und
wir haben das alles schon gehört	wissen theoretisch bescheid -	und
wir haben das alles schon gehört und wissen theoretisch bescheid -	in der realität enden leider zu viele fahrten aus den genannten gründen verhängnisvoll .	aber
welcher schulleiter hat es schon gerne ,	man sich den mund darüber zerreißt , dass man auf dem schulhof von crack bis graß alles bekommen kann , was man zu einem tripp in die welt der träume braucht ?	wenn
auf eine schule , von der jeder weiß , hier gibt es drogen aller art , werden eltern ihre sprösslinge kaum schicken wollen .	ist die diskussion , die ein eltern-stammtisch des jahn-gymnasiums jetzt gemeinsam mit pira angestoßen hat bemerkenswert und deutlich höher zu bewerten , als eine kleine randnotiz .	deshalb
bemerkenswert	deutlich höher zu bewerten , als eine kleine randnotiz .	und
es darf nicht sein , dass zehnjährige zum glimmstängel und zum bier greifen ,	sie es ohne probleme bekommen .	weil
welcher schulleiter hat es schon gerne , wenn man sich den mund darüber zerreißt , dass man auf dem schulhof von crack bis graß alles bekommen kann , was man zu einem tripp in die welt der träume braucht ?	will man ja zu beginn eines neuen schuljahres genügend schüler bekommen .	other
das versteckspiel soll aufhören	eine sachliche debatte geführt werden , an deren ende hilfsangebote für betroffene schüler und eltern stehen könnten .	und
das versteckspiel soll aufhören und eine sachliche debatte geführt werden , an deren ende hilfsangebote für betroffene schüler und eltern stehen könnten .	alle anderen müssen mitmachen .	und
deshalb ist die diskussion , die ein eltern-stammtisch des jahn-gymnasiums jetzt gemeinsam mit pira angestoßen hat bemerkenswert und deutlich höher zu bewerten , als eine kleine randnotiz .	erstmals wird versucht , das problem offensiv zu bewerten .	other
der zuständige stab kennt gefahrenlagen , die von schweren unglücken ausgehen können ,	mit zügen .	other
das reicht nicht mehr aus .	und muss landrat christian gilde jetzt eine gewisse hilflosigkeit erkennen lassen , was das reagieren auf möglichen terror und seine folgen angeht .	so
vordergründig bedroht	einfach nur in verständlicher sorge	oder
schon mehrfach szenarien durchgespielt	gegenmaßnahmen geprobt .	und
das reicht nicht mehr aus .	so muss landrat christian gilde jetzt eine gewisse hilflosigkeit erkennen lassen , was das reagieren auf möglichen terror und seine folgen angeht .	und
keiner hat sich schließlich vor dem 11. september vorstellen können , wozu menschen , von fanatismus getrieben , fähig sind .	nun wird der katastrophenschutz einen neuen stellenwert bekommen .	other
dabei geht es nicht allein um den bauernmarkt , mit dem einige abgeordnete nach den jüngsten ereignissen wohl sowieso schon längst abgeschlossen haben .	es wird die zukunft der anderen betriebe zu bewerten sein , die keine nutzungsuntersagung erhielten , aber seinerzeit auch nicht durch einen bauantrag auffielen .	auch
keine nutzungsuntersagung erhielten ,	seinerzeit auch nicht durch einen bauantrag auffielen .	aber
sollte den güterfelder gemeindevertretern bei ihrer heutigen entscheidung eines klar sein : wer fest entschlossen zurück zur natur will , hat jetzt auch das schicksal von menschen zu verantworten , deren arbeitsplätze er dafür gleichzeitig opfert .	der rechtlichen verfehlungen , die dem marktbetreiber jürgen wache sicher vorzuwerfen sind ,	other
die von den elstalern lange herbei gesehnte umgehungsstraße für den historischen ortskern ist fertig .	ist eines der wichtigsten straßenbauvorhaben der gemeinde verwirklicht .	other
die von den elstalern lange herbei gesehnte umgehungsstraße für den historischen ortskern ist fertig . damit ist eines der wichtigsten straßenbauvorhaben der gemeinde verwirklicht .	doch ist die freude nicht ganz ungetrübt .	und
die von den elstalern lange herbei gesehnte umgehungsstraße für den historischen ortskern ist fertig . damit ist eines der wichtigsten straßenbauvorhaben der gemeinde verwirklicht .	und ist die freude nicht ganz ungetrübt .	doch
und doch ist die freude nicht ganz ungetrübt .	die bahnhofstraße ihrem namen nicht gerecht wird .	weil
daran wird sich bis frühjahr nächsten jahres auch nichts ändern .	sieht man in nächster zeit wohl eher inline-skater als autofahrer auf der fahrbahn .	also
schön für die freizeitsportler ,	für die elstaler heißt das , sie müssen vorerst weiterhin damit leben , dass autos durch ihre unter denkmalschutz stehende ortsmitte brausen .	aber
wird die straße ihren eigentlichen zweck erfüllen ,	den verkehr aus dem ort fern zu halten .	other
wird die straße ihren eigentlichen zweck erfüllen , nämlich den verkehr aus dem ort fern zu halten .	erst der bahnhaltepunkt wieder eröffnet ist ,	wenn
erst wenn der bahnhaltepunkt wieder eröffnet ist , wird die straße ihren eigentlichen zweck erfüllen , nämlich den verkehr aus dem ort fern zu halten . wenn demex im zuge der neuen investitionen am designer outlet center auch noch den " alten spandauer weg " zumachen will , muss der außenring funktionieren .	damit ist gleichzeitig der anstehende generalverkehrsplan nichts weiter als ein " hohler vogel " .	auch
erst wenn der bahnhaltepunkt wieder eröffnet ist , wird die straße ihren eigentlichen zweck erfüllen , nämlich den verkehr aus dem ort fern zu halten .	ist auch gleichzeitig der anstehende generalverkehrsplan nichts weiter als ein " hohler vogel " .	other
muss der außenring funktionieren .	demex im zuge der neuen investitionen am designer outlet center auch noch den " alten spandauer weg " zumachen will ,	wenn
fast möchte man andreas wansing , den geschäftsführer der wobra , händeringend bitten , von seinem plan abstand zu nehmen , aus dem bestand der wobra hinaus wohnungen zu verkaufen .	noch heute sind die schmerzlichen folgen jederzeit in der stadt präsent , den die unüberlegten wobra-verkäufe an die aubis auslösten .	denn
dass die aubis letztlich den berliner senat stürzte ,	in brandenburg kein politiker auch nur eine spur verantwortung übernehmen musste -	aber
in brandenburg aber kein politiker auch nur eine spur verantwortung übernehmen musste -	geld verschleudert und mieter verramscht wurden -	other
obwohl geld verschleudert	mieter verramscht wurden -	und
die damalige aufsichtsratschefin margit spielmann wird am samstag - von der spd wieder als brandenburger bundestagsabgeordnete nominiert .	sie bis heute nicht für ihre wobra-arbeit entlastet wurde und schliesing noch im vorjahr mit der möglichkeit einer klage gegen sie drohte -	other
obwohl sie bis heute nicht für ihre wobra-arbeit entlastet wurde	schliesing noch im vorjahr mit der möglichkeit einer klage gegen sie drohte -	und
zum einen ist es möglich , dass der verkauf vernünftig vorbereitet und mit den mietern abgesprochen ist . zum anderen musste außer mietern und mitarbeitern bei der wobra noch niemand für die fehler des managements und des aufsichtsrates ernsthaft büßen	muss sich wansing auch nicht vor folgen des verkaufs fürchten :	deshalb
dass die aubis letztlich den berliner senat stürzte , in brandenburg aber kein politiker auch nur eine spur verantwortung übernehmen musste - obwohl geld verschleudert und mieter verramscht wurden - ist nur noch eine stadtgeschichtliche fußnote .	zum beweis : die damalige aufsichtsratschefin margit spielmann wird am samstag - obwohl sie bis heute nicht für ihre wobra-arbeit entlastet wurde und schliesing noch im vorjahr mit der möglichkeit einer klage gegen sie drohte - von der spd wieder als brandenburger bundestagsabgeordnete nominiert .	other
das ist kein zufall ,	nervt die meisten jüngeren autoren die ewige besserwisserei der altgedienten .	doch
hört ein großer teil der deutschen intellektuellen inzwischen bewusst weg .	sich günter grass , christa wolf oder stefan heym in politischen angelegenheiten zu wort melden ,	wenn
wenn sich günter grass , christa wolf oder stefan heym in politischen angelegenheiten zu wort melden , hört ein großer teil der deutschen intellektuellen inzwischen bewusst weg .	schröder hat angst , dass die öffentliche meinung wegen der kriegsteilnahme kippt und sich gegen ihn wendet .	doch
die öffentliche meinung wegen der kriegsteilnahme kippt	sich gegen ihn wendet .	und
die öffentliche meinung kippt und sich gegen ihn wendet .	der kriegsteilnahme	other
doch schröder hat angst , dass die öffentliche meinung wegen der kriegsteilnahme kippt und sich gegen ihn wendet .	versucht er , die tuchfühlung zu den meinungsführern nicht zu verlieren .	deshalb
deshalb versucht er , die tuchfühlung zu den meinungsführern nicht zu verlieren .	wo und wer sind sie ?	doch
wollen nur noch gute bücher schreiben	behaupten nicht , dass sie dem kanzler ratschläge erteilen können , die besser sind als die von normalbürgern .	und
die nation hat sich bisher keine neuen klassensprecher gewählt ,	ging der bundeskanzler noch einmal auf die alten zu .	also
vorbei die zeiten , in denen ein einsatzbus mit mehreren beamten auf dem parkplatz stundenlang position beziehen musste ,	mögliche gewalttäter von ihrem tun abzuhalten .	other
gewaltbereite jugendliche ihr katz- und maus-spielchen mit den polizisten trieben ,	sie provozierten , ohne straffällig zu werden .	other
aus der distanz beobachten sie das geschehen	geben den beamten an den monitoren die möglichkeit , die lage nüchtern und mit klarem kopf einzuschätzen .	und
provokateuren wird das objekt ihrer aggression genommen , ihre sticheleien laufen ins leere .	wer straffällig wird , der braucht nicht darauf zu hoffen , dass sein tun unbemerkt bleibt .	und
die technischen augen sehen alles	liefern die entsprechenden beweise .	und
die eigentlich sachlich zu führende auseinandersetzung um die parteispenden von kwr-chef richter an bürgermeister lünsers politverein pro rathenow wird zunehmend emotionaler .	knapp einen monat nach ausbruch der rathenower parteispendenaffäre scheint sich nunmehr wenigstens der gedanke durchzusetzen , die spenden als moralisch nicht akzeptabel zu werten .	aber
hat das umdenken nun auch in teilen von pro rathenow eingesetzt .	nach langem zögern auch die cdu-fraktion sich dieser auffassung anschloss und bürgermeister lünser damit von der fahne wich ,	other
nimmt das verhalten von bürgermeister lünser langsam groteske züge an .	timm mit diesem verhalten pro rathenow helfen dürfte ,	other
die cdu-fraktion sich dieser auffassung anschloss	bürgermeister lünser damit von der fahne wich ,	und
die zeiten , da die literatur aufklärungs- und bekenntnisarbeit mitleisten musste , sind zum glück vorbei .	ist es auch gut , dass das umweltministerium in diesem jahr in engerem sinne auf fachliche leistungen setzt .	deshalb
der coup , den die cdu-ob-kandidatin dietlind tiemann mit dem verfüllen des neustädtischen marktes landet , ist ein gigantischer .	unklar ist , welchen preis rosco dafür haben will , dass er sein stärkstes faustpfand - das loch - aus der hand gibt :	other
wer das problem nach einem halben jahrzehnt des stillstands löst , hat gute chancen , als oberbürgermeister akzeptiert zu werden .	entschlossenes handeln	other
wer das problem nach einem halben jahrzehnt des stillstands durch entschlossenes handeln löst , hat gute chancen , als oberbürgermeister akzeptiert zu werden .	verschwindet das loch wirklich , verschwindet auch der selbsthass , mit dem sich die brandenburger ob ihrer hässlichen mitte geißeln und wegen dem sie sich schämen .	denn
mit dem sich die brandenburger ob ihrer hässlichen mitte geißeln	wegen dem sie sich schämen .	und
das verfüllen zu behindern	so den termin zu kippen ?	und
soll sie versuchen , über die spd-dominierte verwaltung das verfüllen zu behindern und so den termin zu kippen ?	am ende helfen ?	oder
der spd-ob-kandidat helmut schmidt hat angekündigt , er wolle das problem neustadt markt " entschlossen und ohne getöse " ab mai 2002 als chefsache in die hände nehmen ,	er ob wird .	other
sollen sich die bewohner mit knatterkrapfen gestärkt haben .	raubritter bassewitz die kyritzer einst bedrängte ,	als
der kyritzer bäckermeister thomas haupt brachte gestern zum spezialitätenwettbewerb der prignitzer bäcker-innung eine tafel mit , auf der von dieser begebenheit berichtet wird . die rezeptur für seinen knatterkrapfen hat er von seiner großmutter übernommen .	die anderen bäckermeister stellten rezepturen vor , die so wohl kaum bekannt waren .	auch
einmalig dürfte das geflochtene bunte brot von winfried höfler aus perleberg sein ,	einmalig wie die elbwelle von wolfgang grünberg aus lenzen .	other
einmalig dürfte das geflochtene bunte brot von winfried höfler aus perleberg sein , ebenso einmalig wie die elbwelle von wolfgang grünberg aus lenzen .	eine neuentwicklung präsentierte der fretzdorfer thomas hausbalk mit seinem schrotbrot ,	auch
dass sich nicht nur lange frisch hält ,	auch den ansprüchen gesunder ernährung entspricht .	sondern
die meister werden nun ihre spezialitäten auf der grünen woche vorstellen	damit für die prignitz werben .	und
die meister werden nun ihre spezialitäten auf der grünen woche vorstellen und damit für die prignitz werben .	der wettbewerb hat auch gezeigt , dass im handwerk verborgene schätze schlummern - mehr als man sich denkt .	other
kontrollen dieser art erhöhen die sicherheit der jungen passagiere .	Übermüdete fahrer sind nur eine gefahr , die gebannt werden muss .	other
der bus tipptopp in schuss ist , die fahrer ausgeruht , die kinder gesittet	alle anderen autofahrer rücksichtsvoll sind ,	und
besteht immer noch die gefahr von höherer gewalt - der sprichwörtliche blitzschlag lässt sich nicht vermeiden .	selbst der bus tipptopp in schuss ist , die fahrer ausgeruht , die kinder gesittet und alle anderen autofahrer rücksichtsvoll sind ,	wenn
besteht immer noch die gefahr von höherer gewalt - der sprichwörtliche blitzschlag lässt sich nicht vermeiden .	die wahrscheinlichkeit solcher unglücke tendiert gegen null .	other
und die kann man vermeiden :	man die fahrtüchtigkeit aller , die am verkehrsgeschehen beteiligt sind - fahrer , passagiere und fahrzeuge - prüft .	other
größer ist die bedrohung durch so genanntes menschliches und technisches versagen .	die kann man vermeiden : indem man die fahrtüchtigkeit aller , die am verkehrsgeschehen beteiligt sind - fahrer , passagiere und fahrzeuge - prüft .	und
der gesetzgeber hinkt dieser wirklichkeit weit hinterher .	nun scheint sogar unsere landesregierung entschlossen , diese ( scheinbare ! ) gleichbehandlung der beiden fächer endgültig zu beseitigen .	und
stolpe , reiche & co. sagen zwar ja zu einem möglichen kompromissangebot aus karlsruhe ,	dekretieren : einen wahlpflichtbereich ler / religion kann es nicht geben .	other
wird hektisch auf jeden trend reagiert : medienoffensive , schnellläuferklassen , zentralabitur ...	für eine solide finanzierte , langfristige bildungspolitik zu sorgen , die ruhiges arbeiten erlaubt und sich an bedürfnissen orientiert ,	other
die ruhiges arbeiten erlaubt	sich an bedürfnissen orientiert ,	und
ler- und religionslehrer haben sich mit persönlichem einsatz weitergebildet , um ihr fach unterrichten zu können -	die regierung schiebt die anerkennung einer sich bewährenden praxis hinaus .	und
man muss ihr unterstellen , kein interesse am kirchlichen mitwirken in der schule zu haben .	sollte sie alle begrüßen , die zur qualifizierten mitarbeit in dieser problemzone unserer gesellschaft bereit sind .	other
ler- und religionslehrer haben sich mit persönlichem einsatz weitergebildet ,	ihr fach unterrichten zu können -	other
zurecht	was der oberbürgermeister den stadtverordneten gestern bot , war eine konsequent inszenierte posse .	denn
lobte ihn sein chef als " alten fahrensmann "	erklärte dem publikum wortreich , warum schon im januar ein nachfolger bestellt sein muss	und
nicht etwa	die regierungsabsprache mit den christdemokraten soeben perfekt war ;	weil
braucht man für derbe späße ein opfer .	zurecht , denn was der oberbürgermeister den stadtverordneten gestern bot , war eine konsequent inszenierte posse .	other
davon kein wort .	nein , der neue könne schon mal seinen umzug nach potsdam vorbereiten , die kinderlein umschulen , das aufgabenfeld ansehen ...	other
harry-potter-tassen , potter t-shirts , kleine potter-legomännchen und so weiter .	nun folgt gleich das zweite mega-kinoereignis : " der herr der ringe " .	und
da boomt die industrie gewaltig , mag man so denken	die gebeutelten kinos bekommen auch noch einen dicken batzen ab .	und
da boomt die industrie gewaltig , mag man so denken und die gebeutelten kinos bekommen auch noch einen dicken batzen ab .	was macht ein lichtspieltheaterchef in der provinz , der erst abends seine pforten öffnen kann ?	aber
muss er sich verpflichten , die kopie an sieben tagen dreimal hintereinander zu zeigen . egal wie viele zuschauer kommen . das hat viele kinobesitzer empört .	harry potter spielen können ,	other
erwägt so mancher , sich dem einfach zu verweigern .	sie jetzt wieder einen knebelvertrag beim " herrn der ringe " unterschreiben sollen ,	wenn
um harry potter spielen zu können , muss er sich verpflichten , die kopie an sieben tagen dreimal hintereinander zu zeigen . egal wie viele zuschauer kommen . das hat viele kinobesitzer empört . wenn sie jetzt wieder einen knebelvertrag beim " herrn der ringe " unterschreiben sollen , erwägt so mancher , sich dem einfach zu verweigern .	wird man sich nicht nur in katholischen gegenden kaum zwingen lassen , heiligabend und silvester das fantasiespektakel abzuspielen .	other
sind insbesondere die bemühungen um die integration hier lebender nicht-deutscher und aussiedler wichtig .	angesichts der jahren obwaltenden rechtsradikalen umtriebe	other
angesichts der seit jahren obwaltenden rechtsradikalen umtriebe sind insbesondere die bemühungen um die integration hier lebender nicht-deutscher und aussiedler wichtig .	wie könnte so etwas besser funktionieren als über gemeinsame sportliche aktivitäten ?	und
und wie könnte so etwas besser funktionieren als über gemeinsame sportliche aktivitäten ?	ist es aller ehren wert , wenn der verein freizeitpark wittenberge die integrationsprogramme der brandenburgischen sportjugend seit jahren intensiv unterstützt .	so
so ist es aller ehren wert ,	der verein freizeitpark wittenberge die integrationsprogramme der brandenburgischen sportjugend seit jahren intensiv unterstützt .	wenn
so ist es aller ehren wert , wenn der verein freizeitpark wittenberge die integrationsprogramme der brandenburgischen sportjugend seit jahren intensiv unterstützt .	so intensiv , dass deren funktionäre bereits eine vorliebe für die prignitz entwickelt haben .	other
einer , der sie sich zu eigen gemacht hat , erhielt am sonnabend eine auszeichnung : der pritzwalker harry stüwe , regelmäßigen lesern unserer lokal-sportseiten bestens bekannt , wird in der urkunde eine schöne bestätigung für sein engagement sehen .	zum weitermachen : solche aktivitäten sind nicht nur nachahmenswert , sondern auch ein aushängeschild für die region . sie bedürfen unser aller unterstützung .	und
und zwar so intensiv , dass deren funktionäre bereits eine vorliebe für die prignitz entwickelt haben .	darüber hinaus gibt es in diesem kreis ebenso ehrenamtliches engagement im dienste dieser guten sache .	aber
solche aktivitäten sind nicht nur nachahmenswert ,	auch ein aushängeschild für die region . sie bedürfen unser aller unterstützung .	sondern
da können sie schon in erinnerungen schwelgen .	ältere pritzwalker aufs hainholz zu sprechen kommen ,	wenn
voll des lobes waren mitglieder des pritzwalker bauausschusses am mittwoch ,	ein bericht über die bewirtschaftung des stadtforstes auf der tagesordnung ihrer sitzung stand .	als
sowas gibt es selten " , schwärmte etwa wolfgang eichhorst .	dietrich kurtz sagte : " früher als jungs und mit der clique sind wir oft ins hainholz gegangen .	und
wenn ältere pritzwalker aufs hainholz zu sprechen kommen , da können sie schon in erinnerungen schwelgen .	der wunderbare mischwald am rande der stadt entfaltet nicht nur eine nostalgische wirkung auf die menschen .	aber
er ist nach wie vor anziehungspunkt für spaziergänger , radler , läufer und naturliebhaber jeden alters - wenngleich es vielleicht nicht mehr so ist wie früher .	vielleicht täuscht dieser eindruck nur und man nimmt die vielen , erholung suchenden leute im hainholz gar nicht wahr , weil man selbst zu selten dort ist .	aber
er ist nach wie vor anziehungspunkt für spaziergänger , radler , läufer und naturliebhaber jeden alters -	es vielleicht nicht mehr so ist wie früher .	other
man nimmt die vielen , erholung suchenden leute im hainholz gar nicht wahr ,	man selbst zu selten dort ist .	weil
aber vielleicht täuscht dieser eindruck nur und man nimmt die vielen , erholung suchenden leute im hainholz gar nicht wahr , weil man selbst zu selten dort ist .	, was hält sie von einem dezemberausflug ins grüne ab ?	also
geht es überhaupt weiter	steht eine schließung bevor ?	oder
solche fragen beschäftigten auch die besucher , die regelmäßig in den klub in der papenbrucher chaussee kommen .	Ähnliche probleme kennt man auch vom arbeitslosentreff in der rheinsberger straße oder dem frauen- und mädchentreff am marktplatz .	other
abm sind immer nur Übergangslösungen ,	sind sie auch nur kurzfristig angelegt .	deshalb
schließlich geht es dann nicht einfach um das erledigen von arbeiten , sondern auch um vertrauen und nähe .	zumindest bei stellen im sozialen bereich , die die betreuung von menschen betreffen , sollten schon unterschiede gemacht werden .	other
abm sind immer nur Übergangslösungen , deshalb sind sie auch nur kurzfristig angelegt .	nicht jede abm ist gleich .	doch
zumindest bei stellen im sozialen bereich , die die betreuung von menschen betreffen , sollten schon unterschiede gemacht werden .	schließlich geht es nicht einfach um das erledigen von arbeiten , sondern auch um vertrauen und nähe .	dann
schließlich geht es dann nicht einfach um das erledigen von arbeiten ,	auch um vertrauen und nähe .	sondern
das heißt nicht , dass der nachfolger es nicht ebenso gut machen kann .	er muss wieder von ganz vorn anfangen .	aber
aber er muss wieder von ganz vorn anfangen .	das ist der sache im allgemeinen nicht zuträglich .	und
arno rentsch hat recht ,	er sagt , dass abm noch nicht die endgültige lösung ist .	wenn
mit keinem dementi ,	mit offensichtlicher zufriedenheit .	sondern
auf den vorstoß von csu-landesgruppenchef michael glos , auch schäuble komme als kanzlerkandidat in frage , reagierte er mit keinem dementi , sondern mit offensichtlicher zufriedenheit .	schäuble sollte auf der hut sein .	doch
glos setzt bei allem respekt nicht ernsthaft auf einen kanzlerkandidaten schäuble ,	will mit seinem alleingang bayerns ministerpräsidenten edmund stoiber entlasten ,	sondern
dass schäuble im frühjahr 2000 nicht wegen des ermittlungsverfahrens ,	wegen politischer fehler stürzte :	sondern
schäuble ist ein kluger kopf , vielleicht sogar der klügste , den die union zu bieten hat .	er muss aufpassen , nicht plötzlich zwischen allen stühlen zu sitzen .	doch
er hatte den bundestag über die annahme einer 100_000-mark-spende vom waffenhändler schreiber belogen	seine konflikte mit kanzler kohl und der früheren cdu-schatzmeisterin baumeister auf extreme weise eskalieren lassen .	und
die lausitzer braunkohle ag ( laubag ) hat im abgelaufenen geschäftsjahr mit der förderung und dem verkauf von braunkohle erstmals verluste gemacht .	wird erneut deutlich , dass eine neuordnung der energiewirtschaft in ostdeutschland überfällig ist .	other
hielt sie sich bei ihrem lieferanten schadlos .	die veag wegen der liberalisierung des strommarktes unter druck geriet und ihre strompreise senken musste ,	als
damit wird erneut deutlich , dass eine neuordnung der energiewirtschaft in ostdeutschland überfällig ist .	die laubag und ihr wichtigster kunde , die veag , hängen wie siamesische zwillinge voneinander ab .	denn
als die veag hielt sie sich bei ihrem lieferanten schadlos .	der liberalisierung des strommarktes unter druck geriet und ihre strompreise senken musste ,	other
die idee , auch einen gasversorger mit ins boot zu holen , ist im prinzip nicht schlecht .	gilt auch hier , dass zu viele köche den brei verderben können .	other
wohin dann mit den vom urlaub übrig gebliebenen münzen , die bald sowieso nichts mehr wert sind ?	wurde die aktion " euro-cash for kids " gestartet ,	so
die erste box war schneller als gedacht prall gefüllt und schwer ,	sie konnte bereits an den initiator der sammelaktion , den internationalen bund ( ib ) , übergeben werden .	und
so wurde die aktion " euro-cash for kids " gestartet ,	sie fand speziell in luckenwalde und umgebung eine riesige resonanz .	und
hintergrund der idee war die bevorstehende euro-einführung .	wohin mit den vom urlaub übrig gebliebenen münzen , die bald sowieso nichts mehr wert sind ?	dann
noch bis zum jahresende besteht die möglichkeit , restliche urlaubsmoneten in der maz-lokalredaktion abzugeben .	wird das geld umgetauscht und es soll für die intensivierung des internationalen austausches von jugendlichen besonders mit ländern osteuropas eingesetzt werden - vor allem auch als ersatz für ausgebliebene staatliche förderung .	other
danach wird das geld umgetauscht und es soll für die intensivierung des internationalen austausches von jugendlichen besonders mit ländern osteuropas eingesetzt werden	- vor allem als ersatz für ausgebliebene staatliche förderung .	auch
wird das geld umgetauscht	es soll für die intensivierung des internationalen austausches von jugendlichen besonders mit ländern osteuropas eingesetzt werden	und
warum sollten sie nicht noch einen guten zweck erfüllen können ?	so wurde die aktion " euro-cash for kids " gestartet , und sie fand speziell in luckenwalde und umgebung eine riesige resonanz .	so
vielleicht kommen ja jetzt nach den herbstferien noch einige münzen zusammen , in der zweiten box ist jedenfalls noch platz dafür vorhanden .	noch bis zum jahresende besteht die möglichkeit , restliche urlaubsmoneten in der maz-lokalredaktion abzugeben .	other
werden sie verwirklicht	gelingt es der nächsten stadtregierung , das debakel um die gescheiterte ansiedlung am neustadt-markt zu überwinden ,	und
wieder auf die beine zu kommen	vor allem ein besseres image zu gewinnen .	und
gab er ihm den titel " vor feuerschlünden " .	franz fühmann vor fast zwei jahrzehnten sein essay über georg trakls dichtung schrieb ,	als
auch im westen fand das buch aus dem rostocker hinstorff-verlag viel beachtung . bloß den titel wollte man nicht übernehmen , der sei zu sperrig .	der westleser bekam das buch als " der sturz des engels " serviert .	other
engel verkaufen sich einfach besser , hieß es .	so heißt es noch heute , vor allem in der weihnachtszeit .	und
selbst ein gefallener engel kann sicher sein , noch auf einer woge der sympathie zu schweben .	ist es kein wunder , wenn wir beim blick ins telefonbuch in den größeren städten der region keinen einzigen teufel finden , aber engel 21-mal in hennigsdorf , 13-mal in oranienburg , zwölfmal in falkensee und sechsmal in nauen .	so
so ist es kein wunder ,	wir beim blick ins telefonbuch in den größeren städten der region keinen einzigen teufel finden ,	wenn
so ist es kein wunder , wenn wir beim blick ins telefonbuch in den größeren städten der region keinen einzigen teufel finden ,	engel 21-mal in hennigsdorf , 13-mal in oranienburg , zwölfmal in falkensee und sechsmal in nauen .	aber
müssen wir ihnen ja nicht glauben .	werbestrategen die himmelsscharen als verkäufer für handys , abführpillen und aktienpapiere oder als blickfang für erotikmessen missbrauchen ,	wenn
37 millionen mark gibt die stadt 2001 für die unterhaltung eigener immobilien aus .	der wert der liegenschaften beläuft sich auf eine halbe milliarde mark .	und
37 millionen mark gibt die stadt 2001 für die unterhaltung eigener immobilien aus . und der wert der liegenschaften beläuft sich auf eine halbe milliarde mark .	ist die stadt gar nicht so arm wie sie tut .	other
damit ist die stadt gar nicht so arm wie sie tut .	muss sie ihr vermögen richtig einsetzen und verwalten .	other
nur muss sie ihr vermögen richtig einsetzen	verwalten .	und
mit dem konzept lassen sich unterhalts- und personalkosten einsparen	gleichzeitig bleibt geld für die sanierung der oft maroden kommunalen gebäude übrig .	und
die nicht einfach aufgegeben werden	die einer zentralisierung im wege stehen .	und
bisher sprang noch jeder strukturreformer in der verwaltung als tiger	landete als bettvorleger .	und
vergleiche hinken , mag sein	es soll keiner sagen , es sei kein geld da	aber
so einfach ist das ,	man nennt es " politik " .	und
wer endlich ein ordentliches stadion baut , ist eigentlich nur auf der höhe der zeit . .	schulsport findet im jahn-sportpark statt	other
wer endlich ein ordentliches stadion baut , ist eigentlich nur auf der höhe der zeit . schulsport findet im jahn-sportpark ebenfalls statt .	für alle kinder und jugendlichen wäre etwas gutes getan	also
sie wären nach dem sport viel sauberer ,	bessere zeiten rennen sie auf gummi auch	und
kräftig spucken die arbeiter von säbu derzeit in blumenow in die hände . sie wissen , dass eile geboten ist .	ziehen sie einen anbau in die höhe , in dem sich künftig nicht irgendwer , sondern die jüngsten einwohner wohlfühlen sollen .	other
kräftig spucken die arbeiter von säbu derzeit in blumenow in die hände . sie wissen , dass eile geboten ist .	bei aller hektischen geschäftigkeit lassen sie auch die qualität nicht aus dem auge .	aber
eins ist klar : zu danken ist das projekt vielen , in erster linie aber der eigeninitiative der dorfbewohner .	noch wochen ins land gehen , ehe die mädchen und jungen das erste mal ausgelassen im neuen raum spielen .	other
sie gaben nicht klein bei und machten geld locker .	sich ihre sprösslinge wohlfühlen . rundum .	other
zu danken ist das projekt vielen ,	in erster linie der eigeninitiative der dorfbewohner .	aber
sie gaben nicht klein bei	machten geld locker .	und
immerhin stampfen sie ein haus aus dem boden , das nicht in klassischer bauweise - stein auf stein - , sondern in so genannter holztafelbauweise entsteht .	bei aller hektischen geschäftigkeit lassen sie aber auch die qualität nicht aus dem auge .	other
es ist zweifellos ein großer zugewinn , dass eltern heute unter kindertagesstätten wählen können , die unterschiedliche pädagogische konzepte bieten .	es ist von vorteil , dass die kitas einer strengen aufsicht unterliegen , die über die räumlichen bedingungen wacht .	auch
es ist auch von vorteil , dass die kitas einer strengen aufsicht unterliegen , die über die räumlichen bedingungen wacht .	wichtiger als die quadratmetergrößen von spielzimmern , die qualität von bodenbelägen und aseptische waschräume erachten die meisten eltern andere richtwerte .	doch
erinnern sie sich vor allem , ob sie in ihrem kindergarten glücklich waren , ob sie die tanten leiden mochten oder nur sehnsüchtig den abend herbeisehnten .	die knirpse herausgewachsen sind ,	wenn
ob sie in ihrem kindergarten glücklich waren , ob sie die tanten leiden mochten	nur sehnsüchtig den abend herbeisehnten .	oder
im " spatzennest " groß glienicke gehört das klima zu den stärken des hauses ,	das manchmal nach essen riecht .	other
im " spatzennest " groß glienicke gehört das klima zu den stärken des hauses , auch wenn das manchmal nach essen riecht .	die kinder sehen noch , wie gekocht wird , anstatt mit assiettenkost abgespeist zu werden .	aber
sehen noch , wie gekocht wird ,	mit assiettenkost abgespeist zu werden .	other
all das weiß man im ort zu schätzen ,	setzt nun , da ein betrugsskandal das haus erschüttert , eine rettungsaktion ein , der man nur erfolg wünschen kann .	other
aber nicht jede ansicht berücksichtigen	ich kann mir die meinung von 220_000 menschen in meinem wahlkreis anhören ,	other
lag es am klaren bekenntnis zur politik des bundeskanzlers , am uneingeschränkten verteidigen der kosovo- und mazedonien-einsätze der bundeswehr	einfach daran , dass die etwa 60 leute im raum allzu kritikloses bewerten der regierenden zu erkennen glaubten ?	oder
als sich bahr mit einem " auch ein minister muss sich irren können " verbal vor rudolf scharping stellte .	es förderte nicht unbedingt die sympathien ,	auch
es förderte auch nicht unbedingt die sympathien ,	sich bahr mit einem " auch ein minister muss sich irren können " verbal vor rudolf scharping stellte .	als
es ging um das bombodrom in der kyritz-ruppiner heide , das der einstige kanzlerkandidat abschaffen wollte , wovon er als verteidigungsminister heute nichts mehr wissen will . oder darf .	da schließt sich der kreis .	und
es ging um das bombodrom in der kyritz-ruppiner heide , das der einstige kanzlerkandidat abschaffen wollte , wovon er als verteidigungsminister heute nichts mehr wissen will .	darf .	oder
" politiker sind auch nur menschen . "	nur haben sie im gegensatz zu ihren wählern entscheidungen zu treffen .	other
sie sind rebellisch	machen dumme sachen	und
sie wegzuschließen , scheint eine lösung zu sein .	nicht alle jugendlichen lassen sich während schwieriger lebensphasen einfach wegsperren .	aber
aber nicht alle jugendlichen lassen sich während schwieriger lebensphasen einfach wegsperren	. ist es sehr lobenswert , dass sich auch in königs wusterhausen der verein jugendrechtshaus gegründet hat	deshalb
sie wollen rechtsbewusstsein lehren , ansprechpartner sein	die jungen leute an die regeln des menschlichen zusammenlebens heranführen .	und
orientierungslose menschen gibt es überall .	vielen ostdeutschen wurde wendebedingt eingeredet : ihr habt alles falsch gemacht !	other
vielen ostdeutschen wurde wendebedingt jedoch eingeredet : ihr habt alles falsch gemacht !	das irritiert .	und
vielen ostdeutschen wurde wendebedingt jedoch eingeredet : ihr habt alles falsch gemacht ! und das irritiert .	verlor ein großteil der ehemaligen ddr-bürger die arbeit , damit den sozialen halt .	other
die vereinsmitglieder des jugendrechtshauses wollen zuhören .	das ist ein guter erster schritt .	und
sie wollen rechtsbewusstsein lehren , ansprechpartner sein und die jungen leute an die regeln des menschlichen zusammenlebens heranführen .	auch weil elternhäuser und schulen dies nicht immer schaffen .	other
eine frau von adel sitzt mit unsichtbaren gästen am tisch	trinkt sich langsam aber sicher ins abseits .	und
eine frau von adel sitzt mit unsichtbaren gästen am tisch und trinkt sich langsam aber sicher ins abseits .	sie betont : " same procedure as every year " , alles soll so ablaufen , wie jedes jahr .	other
es ist bekannt : same procedure .	könnte auch der gleiche kommentar abgegeben werden :	deshalb
den streit kennt fast jeder , die stadt selbst nicht .	irgendwann ist der platz sowieso nicht mehr nötig .	aber
aber irgendwann ist der platz sowieso nicht mehr nötig .	muss kein tornado mehr üben , weil geschosse unbemannt fliegen und via satellit ins ziel gebracht werden .	dann
dann muss kein tornado mehr üben ,	geschosse unbemannt fliegen und via satellit ins ziel gebracht werden .	weil
das ist zwar auch keine angenehme zukunftsvision ,	der streit wäre dann endlich vom tisch .	other
geschosse unbemannt fliegen	via satellit ins ziel gebracht werden .	und
dann muss kein tornado mehr üben , weil geschosse unbemannt fliegen und via satellit ins ziel gebracht werden .	aber der streit wäre endlich vom tisch .	dann
der streit muss endlich entschieden werden . er nutzt keinem - weder der bundeswehr noch den schießplatzgemeinden und der region .	die stadt wittstock hat mit einem schlechten image zu kämpfen .	und
" same procedure as every year " , alles soll so ablaufen , wie jedes jahr .	der satz trifft auch auf die wittstocker region zu .	auch
die polizei weiß es besser . und mancher rektor weiß es auch .	: es soll nichts nach außen dringen , weil die schülerzahlen sinken und die schließung droht , wenn die schule erst einmal in verruf kommt .	other
die polizei weiß es besser .	mancher rektor weiß es auch .	und
es soll nichts nach außen dringen ,	die schülerzahlen sinken und die schließung droht , wenn die schule erst einmal in verruf kommt .	weil
die schülerzahlen sinken	die schließung droht ,	und
die schülerzahlen sinken und die schließung droht ,	die schule erst einmal in verruf kommt .	wenn
es soll nichts nach außen dringen , weil die schülerzahlen sinken und die schließung droht , wenn die schule erst einmal in verruf kommt .	durch verschweigen bekommt man das problem nicht aus der welt .	other
wo alle die augen offen halten	über das problem sprechen .	und
die riesigen gewinnspannen des drogenhandels locken kriminelle an	die immensen preise für illegale drogen zwingen die abhängigen , sich das geld durch einbrüche und Überfälle zu verschaffen .	und
die riesigen gewinnspannen des drogenhandels locken kriminelle an und die immensen preise für illegale drogen zwingen die abhängigen , sich das geld durch einbrüche und Überfälle zu verschaffen .	schade ist es auch , dass sich die eltern der jugendlichen im amtsbereich temnitz am dienstag so wenig für die tipps der polizei interessierten .	deshalb
wie ein joint eigentlich aussieht	riecht ,	und
die sich auch dann nicht schließen ,	man der tochter mit der taschenlampe ins auge leuchtet -	other
wer vom wursthof zum markt will , muss gut aufpassen . parkende autos bis an die einmündungen behindern die sicht . oft ist erst auf der straßenmitte zu sehen , ob abgebogen werden kann . fußgänger und radfahrer wuseln dazwischen und sollen keinen schaden nehmen .	ist es gut , dass nicht alle wünsche erfüllt werden .	other
fußgänger und radfahrer wuseln dazwischen	sollen keinen schaden nehmen .	und
da ist es gut , dass nicht alle wünsche erfüllt werden .	der nach Öffnung des wursthofes in beide richtungen .	other
sicher ist es ein seltsames argument , dass die bordsteine für den verkehr in beide richtungen zwölf zentimeter hoch sein sollen ,	wo es in vielen straßen gar keine gibt .	doch
sicher ist es ein seltsames argument , dass die bordsteine für den verkehr in beide richtungen zwölf zentimeter hoch sein sollen , wo es doch in vielen straßen gar keine gibt .	in der mönchen- und in der zinnaer straße tritt der fußgänger eben nicht gleich auf die fahrbahn .	aber
erst mal muss er an parkenden autos vorbei .	die mittelstraße ist nicht so einfach mit den anderen straßen zu vergleichen .	und
der vorschlag zu prüfen , ob eine richtungsänderung in den vorhandenden einbahnstraßen zu kürzeren wegen führt , ist brauchbar .	dann müssten diejenigen , die aus der lessingstraße ins zentrum wollen , umwege fahren .	doch
ob eine richtungsänderung in den vorhandenden einbahnstraßen zu kürzeren wegen führt , ist brauchbar .	müssten diejenigen , die aus der lessingstraße ins zentrum wollen , umwege fahren .	dann
der rausschmiss der Öffentlichkeit aus dem kita-untersuchungs-ausschuss mag für sich genommen nur ein stück aus dem tollhaus sein .	aufgefädelt auf die kette vieler ereignisse rund um das versagen der verwaltung in sachen kitas ist dieser akt nur die nächste perle .	doch
versprach transparenz	hat es bis heute nicht geschafft , die eltern kita für kita präzise und detailliert über den zustand der häuser zu informieren .	und
verhindern konnte kreisel den ausschuss nicht ,	verzögern .	aber
gefragt , was er gegen den ausschuss habe , stellte er sich bockig und schwieg .	nun erklärt das rechtsamt , dass der ausschuss geschlossen zu tagen habe .	und
doch aufgefädelt auf die kette vieler ereignisse rund um das versagen der verwaltung in sachen kitas ist dieser akt nur die nächste perle .	es begann damit , dass die eltern druck machen mussten , damit überhaupt etwas geschieht .	other
nach den anschlägen in amerika wurde dieser zustand leider noch verschärft .	inzwischen hatte sich der wachsame deutsche bekanntlich im kopf sein eigenes bild des islamistischen kämpfers zurechtgelegt	denn
denn inzwischen hatte sich der wachsame deutsche bekanntlich im kopf sein eigenes bild des islamistischen kämpfers zurechtgelegt	wehe dem , der diesem bild auch nur im entferntesten ähnelte ...	und
gut , dass inzwischen wieder länger nachgedacht wird . gut , dass veranstaltungen wie die interkulturelle woche in ludwigsfelde weitergeführt und als forum der verständigung für deutsche und ausländer genutzt werden .	nur so , mit beharrlichkeit , werden falsche bilder in den köpfen zurechtgerückt .	denn
das zusammenleben von ausländern und deutschen hier in brandenburg , wo der anteil der menschen aus anderen ländern verschwindend gering ist , war auch vor dem 11. september 2001 nicht ohne probleme .	im gegenteil .	other
wer etwa in den alten bundesländern unterwegs war , der musste erleben , dass " brandenburg " und " ausländerfeindlichkeit " oft als synonyme betrachtet wurden - durchaus kein angenehmer zustand .	nach den anschlägen in amerika wurde dieser zustand leider noch verschärft .	other
euphorische beifallsstürme gab es in fröhden nicht für die dorferneuerungsplanung .	das war kaum zu erwarten ,	auch
das war auch kaum zu erwarten ,	handelt es sich um ein gemeinschaftswerk , an dem die einwohner mitgewirkt haben .	doch
das war auch kaum zu erwarten , handelt es sich doch um ein gemeinschaftswerk , an dem die einwohner mitgewirkt haben .	blieben auch kaum fragen offen , zumindest nicht solche , die die gestaltung der beiden jüterboger ortsteile betrifft .	deshalb
das interesse an der planung war groß , die beteiligung an den arbeitskreisen hat es gezeigt .	die freude hält sich in grenzen ,	doch
doch die freude hält sich in grenzen ,	inzwischen weiß jeder , dass die fördermittelgießkanne nur noch tröpfchenweise austeilt .	denn
wer auf das ja-wort aus brieselang warten kann , keine scheu vor seitenlangen fragebögen hat	in kauf nimmt , dass er wahrscheinlich nicht billiger wegkommt , als wenn er nach eigenen vorstellungen die fassade gestrichen hätte -	und
schweren herzens wird sich die stadt von ihrem geld trennen ,	wenn es darum geht , die eigenanteile für bestimmte vorhaben zur verfügung zu stellen .	other
die dorferneuerungsplanung ist längst keine garantie mehr für grenzenlosen geldsegen .	könnte es passieren , dass viele schöne vorhaben nur visionen bleiben .	so
schweren herzens wird sich die stadt von ihrem geld trennen ,	es nämlich darum geht , die eigenanteile für bestimmte vorhaben zur verfügung zu stellen .	wenn
der traum vieler menschen von der weißen weihnacht ist diesmal in der prignitz teilweise wahr geworden .	an heiligabend hüllte sich die landschaft in ein schneekleid .	denn
denn an heiligabend hüllte sich die landschaft in ein schneekleid .	auch wenn an den beiden feiertagen ein großteil wieder weg getaut ist , so dürften sich vor allem die kinder über ein standesgemäßes fest gefreut haben .	und
so dürften sich vor allem die kinder über ein standesgemäßes fest gefreut haben .	und an den beiden feiertagen ein großteil wieder weg getaut ist ,	other
und auch wenn an den beiden feiertagen ein großteil wieder weg getaut ist ,	dürften sich vor allem die kinder über ein standesgemäßes fest gefreut haben .	so
Übrigens zum zweiten mal nacheinander .	wer erinnert sich nicht an den schneeeinbruch im vorjahr , der rechtzeitig zum fest die prignitz erreichte und sogar über die feiertage hinaus für eine winterlandschaft sorgte ?	denn
der rechtzeitig zum fest die prignitz erreichte	sogar über die feiertage hinaus für eine winterlandschaft sorgte ?	und
denn wer erinnert sich nicht an den schneeeinbruch im vorjahr , der rechtzeitig zum fest die prignitz erreichte und sogar über die feiertage hinaus für eine winterlandschaft sorgte ?	es kann keine rede davon sein , dass die weiße weihnacht ein phänomen ist , das der vergangenheit angehört .	also
selbst auf mallorca lag zum fest schnee	nur in 1000 meter höhe .	other
folgt man dem polizeibericht ,	hielten sich die folgen in der prignitz in grenzen .	so
immerhin bleiben den menschen in diesen regionen die wetterunbilden auf den straßen erspart .	folgt man dem polizeibericht , so hielten sich die folgen in der prignitz in grenzen .	doch
die meisten menschen waren wohl auf den wetterumschwung eingestellt .	blieben ganz einfach zu hause , wie sich das zu weihnachten gehört .	oder
oder blieben ganz einfach zu hause ,	sich das zu weihnachten gehört .	other
in diesem jahr reichte sie bis weit in den süden .	selbst auf mallorca lag zum fest schnee - wenn auch nur in 1000 meter höhe .	other
selbst auf mallorca lag zum fest schnee - wenn auch nur in 1000 meter höhe .	anderswo wiederum wird des fest immer bei sengender hitze gefeiert - unvorstellbar für uns .	other
immerhin bleiben den menschen in diesen regionen die wetterunbilden auf den straßen erspart .	anderswo wiederum wird des fest immer bei sengender hitze gefeiert - unvorstellbar für uns .	other
eltern beschweren sich über veraltete schulbücher , kommunen jammern über leere kassen	schulbuchverlage beklagen umsatzeinbrüche .	und
zum anderen müssen sich märkische eltern am buchkauf beteiligen .	wurden nach der wende fast alle schulbuchbestände ausgetauscht ,	other
trommeln gehört halt zum geschäft .	unterm strich stehen brandenburgs schulen ganz gut da .	doch
dafür gibt es sogar lob von den schulbuchverlagen .	in vielen alten bundesländern gilt noch immer die lernmittelfreiheit :	denn
wird die regelmäßige schulbucherneuerung zur illusion .	immer mehr kommunen finanziell ausbluten ,	wenn
wenn immer mehr kommunen finanziell ausbluten , wird die regelmäßige schulbucherneuerung zur illusion .	ist auch die landesregierung gefragt :	deshalb
für teure modellprojekte wie schnellläuferklassen oder ganztagsschulen geld locker gemacht ,	an der grundausstattung gespart wird .	aber
der preis dafür ist hoch - gerade dort wird oft mit völlig veraltetem material gearbeitet .	doch auch brandenburg muss aufpassen .	doch
video-ansprachen osama bin ladens gar nicht mehr	nur stark gekürzt zu senden .	oder
das ist natürlich ein eingriff in die pressefreiheit	doch ist nicht auszuschließen , dass versteckte botschaften zum " aufwecken " so genannter " schläfer " darin verborgen sind .	und
ein authentischer ortstermin	doch wissen die berichterstatter nicht wirklich , was sie da mit eigenen augen sehen :	und
ein authentischer ortstermin	und wissen die berichterstatter nicht wirklich , was sie da mit eigenen augen sehen :	doch
was war bereits zerstört ? wer hat es zerstört ?	zu wessen werkzeug werden ihre reportagen am ende ?	und
das ist natürlich ein eingriff in die pressefreiheit	und ist nicht auszuschließen , dass versteckte botschaften zum " aufwecken " so genannter " schläfer " darin verborgen sind .	doch
die drei grundschulen hohenstückens gehen zusammen ,	so schnell wie möglich .	other
weil für dann rund 500 schüler nur im schulhaus am marktplatz genügend raum ist , nistet sich die dann neue schule erst einmal dort ein .	nun hat die künftige schulkonferenz genügend zeit , den endgültigen standort zu wählen .	und
nistet sich die dann neue schule erst einmal dort ein .	für dann rund 500 schüler nur im schulhaus am marktplatz genügend raum ist ,	weil
dass die marktplatz-schule nicht in frage kommt , ist seit jahren klar . doppelschulen , und dazu gehört dieses gebäude , will die stadt nicht sanieren .	der vorschlag , den die verwaltung jetzt den stadtverordneten unterbreiten will , wäre nicht ohne die weitsicht der drei schulkonferenzen zustande gekommen .	other
die nötige ruhe , zuversicht und planungssicherheit ,	unterricht vernünftig gestalten zu können .	other
eher schon durchs glücksspiel .	der große wurf gelingt bekanntlich nur den allerwenigsten .	doch
die masse hofft	hofft -	und
die masse hofft und hofft -	geht doch am ende leer aus .	und
die masse hofft und hofft -	und geht am ende leer aus .	doch
all jenen sei gesagt : ihr einsatz ist mehr als eine zerplatzte illusion .	wer an der " glücksspirale " dreht , beweist sich indirekt als wohltäter .	other
wer zum beispiel an der " glücksspirale " dreht , beweist sich indirekt als wohltäter .	seit 1991 wurden 105 millionen mark der einnahmen der " glücksspirale " zweckgebunden an die stiftung denkmalschutz weitergereicht .	denn
die wiederum förderte damit 264 bauten im brandenburgischen ,	den verfall zu stoppen , ihre schönheit zu bewahren , sie den menschen wieder zugänglich zu machen .	other
die ein stimmiges nutzungs- und finanzierungskonzept vorlegen	sich selbst einbringen - mit geld , muskelhypothek und ihrem herzblut .	und
alles halb so schlimm , sie taten gutes	sie also an diesem wochenende wieder leer ausgehen :	other
unterstützt werden bauherren , die ein stimmiges nutzungs- und finanzierungskonzept vorlegen und sich selbst einbringen - mit geld , muskelhypothek und ihrem herzblut .	falls sie an diesem wochenende wieder leer ausgehen :	also
durch arbeit wird man selten reich .	eher schon durchs glücksspiel .	other
denn seit 1991 wurden 105 millionen mark der einnahmen der " glücksspirale " zweckgebunden an die stiftung denkmalschutz weitergereicht .	die wiederum förderte damit 264 bauten im brandenburgischen , um den verfall zu stoppen , ihre schönheit zu bewahren , sie den menschen wieder zugänglich zu machen .	other
der kanzler gibt seinen berliner genossen den entscheidenden fingerzeig in richtung rot-gelb-grüner ampel-koalition ,	er sich die liberalen als möglichen koalitionspartner für die bundestagswahl im kommenden jahr warmhalten möchte .	weil
und fdp-luftikus jürgen w. möllemann bereist seinerseits schon jetzt eifrig den nahen osten ,	für diesen fall gerüstet sein	other
der kanzler gibt seinen berliner genossen den entscheidenden fingerzeig in richtung rot-gelb-grüner ampel-koalition , weil er sich die liberalen als möglichen koalitionspartner für die bundestagswahl im kommenden jahr warmhalten möchte .	fdp-luftikus jürgen w. möllemann bereist seinerseits schon jetzt eifrig den nahen osten , um für diesen fall gerüstet zu sein und sich als neuer liberaler außenminister zu empfehlen .	und
für diesen fall gerüstet zu sein	sich als neuer liberaler außenminister zu empfehlen .	und
unter rechtsstaatlichen gesichtspunkten sollte diese methode der hinrichtungen auf verdacht in der tat besser nicht schule machen ,	ist ein möchtegern-chefdiplomat womöglich besser beraten , nicht schon vor amtsantritt verbrannte erde ausgerechnet in israel zu hinterlassen .	doch
zwar machten die haushaltspolitiker der spd im vorfeld ihrer wochenendklausur große welle mit horrorlisten möglicher sparpositionen .	am ende bleibt alles beim alten : dass millionen fehlen , hindert nicht daran , sie zu verteilen .	other
bosse hatte empfohlen , auf den teuren theaterneubau zu verzichten .	der versuch , das projekt sterben zu lassen , hätte angesichts der dünnen spd-cdu-mehrheit im desaster geendet .	doch
doch der versuch , das projekt sterben zu lassen , hätte angesichts der dünnen spd-cdu-mehrheit im desaster geendet .	bekannte man sich lieber einmütig zu dem vorhaben .	also
wie bei der kammerakademie soll die verwaltung hier und da ein bisschen umschichten , nirgendwo darf es richtig weh tut .	das füllhorn schüttet man über kitas und schulen aus .	other
bleibt aber am ende wieder nur der verkauf von tafelsilber .	die sicher notwendigen investitionen tätigen zu können ,	other
dieses problem und das haushaltsloch werden nicht verschwinden ,	man bosse in die wüste geschickt hat .	wenn
sie werden es nicht akzeptieren können :	zum einen sind es zumeist frauen mit kindern , die im einzelhandel arbeiten .	denn
denn zum einen sind es zumeist frauen mit kindern , die im einzelhandel arbeiten .	die sind nun einmal nicht so mobil , wie es alleinstehende arbeitnehmer sind .	und
sie werden es nicht akzeptieren können :	sind es zumeist frauen mit kindern , die im einzelhandel arbeiten .	other
zum anderen sind auch die löhne im einzelhandel nicht so hoch , als dass sich täglich eine weite fahrt zur arbeit für die mitarbeiter lohnen würde .	denn zum einen sind es zumeist frauen mit kindern , die im einzelhandel arbeiten . und die sind nun einmal nicht so mobil , wie es alleinstehende arbeitnehmer sind .	other
zum anderen sind auch die löhne im einzelhandel nicht so hoch ,	dass sich täglich eine weite fahrt zur arbeit für die mitarbeiter lohnen würde .	als
der konzern will sich heute noch nicht zu seinen plänen äußern .	sicher ist , dass bei einer Übernahme die alten verträge übernommen werden müssten , und der neue inhaber bei lohnverhandlungen dann keinen spielraum hätte .	other
die alten verträge übernommen werden müssten	der neue inhaber bei lohnverhandlungen dann keinen spielraum hätte .	und
bei einer Übernahme die alten verträge übernommen werden müssten	, und der neue inhaber bei lohnverhandlungen keinen spielraum hätte .	dann
die staunenden zuschauer störte das aber überhaupt nicht .	die quoten steigen und steigen .	und
da dachten sich die mainzelmänner , warum sollen wir unser zugpferd kerner nur einmal die woche loslassen ?	beschlossen , dass der sympathieträger gleich vier mal in der woche zu später stunde seine prominenten und weniger prominenten befragt .	und
die emanzipierte verona feldbusch und die emanze alice schwarzer machten den talkmaster mit ihrem verbalen gefecht über das gängige frauenbild mundtot .	die staunenden zuschauer störte das überhaupt nicht .	aber
und beschlossen , dass der sympathieträger gleich vier mal in der woche zu später stunde seine prominenten und weniger prominenten befragt .	auf diesen sendeplätzen laufen wiederholungen , die ohnehin kein mensch sieht .	other
trotzdem darf bezweifelt werden , ob das der sendung selbst und ihrer " allzweckwaffe " kerner wirklich zu gute kommt .	das mag dem zweiten unterm quotenstrich mehr bringen ,	other
das mag zwar dem zweiten unterm quotenstrich mehr bringen ,	darf bezweifelt werden , ob das der sendung selbst und ihrer " allzweckwaffe " kerner wirklich zu gute kommt .	other
es wäre schade ,	durch kurzfristiges quotendenken ein so beliebtes format verheizt wird .	wenn
sie hatte das ergebnis der wirtschaftlichkeitsrechnung für den betrieb der stammbahn von potsdam nach berlin in diesem jahr immer wieder angekündigt	verschob die bekanntgabe der zahlen mit schöner regelmäßigkeit .	und
sie hatte das ergebnis der wirtschaftlichkeitsrechnung für den betrieb der stammbahn von potsdam nach berlin in diesem jahr immer wieder angekündigt und verschob die bekanntgabe der zahlen mit schöner regelmäßigkeit .	das unternehmen nährte spekulationen , dass die bis 1945 existierende bahnstrecke wohl doch keine chance auf wiederaufbau habe .	other
glaubt man den neuesten verlautbarungen des bahnsprechers und der kleinmachnower initiative " stammbahn " ist dem nicht so .	brütet man über einer abgespeckten variante , die kosten sparen und die belastungen für die länder berlin und brandenburg minimieren soll .	other
kosten sparen	die belastungen für die länder berlin und brandenburg minimieren soll .	und
für die realisierung des projekts wird die zeit langsam knapp . fährt die stammbahn bis 2006 nicht , muss die deutsche bahn ag dieses geld zurückerstatten .	der bund ging bereits mit 50 millionen mark in vorleistung , um die einführung der gleise in den berliner tiergartentunnel zu gewährleisten .	denn
denn der bund ging bereits mit 50 millionen mark in vorleistung ,	die einführung der gleise in den berliner tiergartentunnel gewährleisten .	other
denn der bund ging bereits mit 50 millionen mark in vorleistung , um die einführung der gleise in den berliner tiergartentunnel zu gewährleisten . fährt die stammbahn bis 2006 nicht , muss die deutsche bahn ag dieses geld zurückerstatten .	der klärung bedarf , wie das problem des schallschutzes für betroffene anwohner in kleinmachnow und berlin gelöst werden soll .	other
der klärung bedarf außerdem , wie das problem des schallschutzes für betroffene anwohner in kleinmachnow und berlin gelöst werden soll .	es bleibt spannend beim endlos-thema " stammbahn " .	also
schüler bringen sie in die erde	sorgen dafür , dass es im frühjahr noch bunter ist als sonst auf kommunalen flächen .	und
es machte schon spaß zuzusehen , mit welchem eifer die mädchen und jungen auf der großen freifläche in der berliner straße zu werke gingen .	das ganze hat mit sicherheit auch einen erzieherischen nutzen :	und
wer weiß , wie viel arbeit in solch einer pflanzaktion steckt , schätzt das ergebnis am ende umso mehr .	es weckt den stolz darauf , etwas für die allgemeinheit getan zu haben , schafft verbundenheit mit der stadt .	und
einige ,	es in anderen gruppen keinen platz mehr gab .	weil
die kreistagsabgeordneten im kreis- und krankenhausausschuss haben viele argumente gehört	müssen sich nun entscheiden .	und
landrat burkhard schröder hat bereits angedeutet , dass er diese entscheidungen den mitgliedern des kreistages überlassen will .	darf man auf die vorlage aus der kreisverwaltung gespannt sein .	so
entweder das paracelsus-krankenhaus bildet einen regionalen klinikverbund mit der nauener havellandklinik unter dem dach einer kreiseigenen gmbh	das rathenower krankenhaus wird an einen freien träger abgegeben .	other
will der kreistag auch in rathenow seinen einfluss auf die krankenhausentwicklung behalten , wird er sich kaum für einen freien träger entscheiden können .	das allein darf nicht grundlage für diesen wichtigen beschluss sein .	doch
das krankenhaus soll der bekommen , der die wohnortnahe versorgung von patienten in rathenow sicherstellen kann	darüberhinaus die betriebswirtschaftliche und medizinische qualität des paracelsus-krankenhauses nicht nur erhält sondern stabilisiert .	und
das krankenhaus soll der bekommen , der die wohnortnahe versorgung von patienten in rathenow sicherstellen kann	und die betriebswirtschaftliche und medizinische qualität des paracelsus-krankenhauses nicht nur erhält sondern stabilisiert .	other
wenn ein freier träger das besser kann als eine kreis-gmbh ,	soll er das krankenhaus haben .	other
nicht nur erhält	stabilisiert .	sondern
die anhörung zur zukunft des paracelsus-krankenhauses ist vorbei .	die kreistagsabgeordneten im kreis- und krankenhausausschuss haben viele argumente gehört und müssen sich nun entscheiden .	other
eigentlich nicht ,	für fußball-deutschland gab es gestern schon die schönste bescherung .	doch
rudolf völler , den volkes mund liebevoll " ruuuuudi " ruft , hat sein ja-wort als nationaler teamchef bis zum wm-finale 2006 in berlin gegeben -	den faxgeräten in der frankfurter dfb-zentrale damit den k.o. versetzt .	und
hat der ehemalige torjäger mit der wm-qualifikation seines teams für fernost enorm an profil gewonnen und das image des unverbindlichen " ich-versuch's-einfach-mal"-typen verloren .	längst kein taktik-guru ,	other
am besten schon bei der nächsten wm .	wäre selbst im juni weihnachten .	dann
hat der ehemalige torjäger mit der wm-qualifikation seines teams für fernost enorm an profil gewonnen	das image des unverbindlichen " ich-versuch's-einfach-mal"-typen verloren .	und
völler kann fußballnationalspieler , fans und fernsehen hinter sich vereinen , schafft perspektiven	verspricht , " dass wieder attraktiver fußball gespielt wird " .	und
ist es eine sinnvolle veranstaltung ,	schon allein an diese freiwillige tätigkeit erinnern ,	other
nicht nur einsicht in die notwendigkeit	, - das war spürbar - auch begeisterung .	sondern
das wiederum sollten die mitglieder der vereine und selbsthilfegruppen wirklich selbst machen .	ihr engagement für soziale , kulturelle und sportliche belange ist nicht nur einsicht in die notwendigkeit , sondern - das war spürbar - auch begeisterung .	other
das wiederum sollten die mitglieder der vereine und selbsthilfegruppen wirklich selbst machen . ihr engagement für soziale , kulturelle und sportliche belange ist nämlich nicht nur einsicht in die notwendigkeit , sondern - das war spürbar - auch begeisterung .	die politik , die sich in diesem jahr aktionismus in kampagnen mit ehrenpreisen , gründung von freiwilligenagenturen und ähnlichen initiativen verordnet hat , sollte sich tunlichst zurückhalten .	other
sozialabbau betreibt ( etwa die streichung des gehörlosengeldes plant ) , sport-unternehmen subventioniert ( lausitzring )	kultur stets nur auf rentabilität prüft	und
das wiederum sollten die mitglieder der vereine und selbsthilfegruppen wirklich selbst machen .	neben der präsentation ist es eine gute möglichkeit , mitglieder zu werben .	other
vor allem kommerzielle veranstalter werden ab 2002 gut zur kasse gebeten .	die einnahmen sind nur ein tropfen auf den heißen stein .	other
je mehr veranstaltungen stattfinden , desto weniger wird der stadthaushalt belastet . die halle muss ausgelastet sein .	in der region gibt es konkurrenz .	und
und in der region gibt es konkurrenz .	die nachbarstädte bieten veranstaltern genügend platz .	auch
auch die nachbarstädte bieten veranstaltern genügend platz .	wittstock muss sich erst einen namen machen .	other
weniger wird der stadthaushalt belastet . die halle muss ausgelastet sein .	mehr veranstaltungen stattfinden ,	other
lange geplant , endlich gebaut -	nun doch an der realität vorbei ?	und
wenn die geplanten bushaltestellen für die b_96-ortsdurchfahrt groß machnow ungünstig sind -	warum hat die verkehrsgesellschaft nicht rechtzeitig während der planungsphase ihre einwände erhoben und vorschläge gemacht ?	other
ihre einwände erhoben	vorschläge gemacht ?	und
die fahrgäste stehen teilweise im gras	müssen bei schlechtwetter über einen schlammigen trampelpfad zum nächsten befestigten bürgersteig laufen .	und
so wirkt das wie jener streich der schildbürger , die licht ins rathaus tragen wollten , weil sie die fenster vergessen hatten .	jetzt nachträglich woanders haltestellen gebaut werden müssen ,	wenn
wenn jetzt nachträglich woanders haltestellen gebaut werden müssen ,	wirkt das wie jener streich der schildbürger , die licht ins rathaus tragen wollten , weil sie die fenster vergessen hatten .	so
die licht ins rathaus tragen wollten ,	sie die fenster vergessen hatten .	weil
wer wüsste das besser als die strategen von der bundeswehr .	in sachen bombodrom orientieren sich die militärs ungeniert am vorbild des alten " marschalls vorwärts " namens blücher .	other
in sachen bombodrom orientieren sich die militärs jedenfalls ungeniert am vorbild des alten " marschalls vorwärts " namens blücher .	eines der hauptargumente der schießplatz-gegner - die gefahr für den tourismus - wollen sie mit einem frontalangriff aus dem weg räumen .	denn
denn eines der hauptargumente der schießplatz-gegner - die gefahr für den tourismus - wollen sie mit einem frontalangriff aus dem weg räumen .	heißt es in einem bundeswehr-papier knapp , dass das bombodrom " keine relevanten auswirkungen " auf den tourismus haben wird .	so
nun könnte man ein halbes stündchen lang mutmaßen , wo die militärs denn so urlaub machen .	werden sich zivilisten und uniformträger dabei nicht wirklich unterscheiden .	doch
die werden nicht an den ruppiner see oder zum rheinsberger schloss strömen .	spektakulärer tiefflüge	other
die werden nicht wegen spektakulärer tiefflüge an den ruppiner see oder zum rheinsberger schloss strömen .	wird wieder mal deutlich , dass die bundeswehr die region mit ihren sorgen und mit ihren chancen überhaupt nicht ernst nimmt .	other
nein , das tut sich niemand an .	namentlich nicht die leute , die in der nähe von berlin ruhe und natur suchen .	other
ohne zweifel profitiert die vom landkreis getragene einrichtung von der im august im benachbarten barockschloss eröffneten ausstellung zur brandenburgisch-preußischen schulgeschichte .	wer das mit großem aufwand sanierte schloss besucht , kommt zwangsläufig an der alten dorfschule vorbei .	denn
das preußenjahr geht zu ende ,	schloss- und schulmuseum werden weiter von sich reden machen .	doch
sie konnte ihr traditionsreiches geschäft nicht mehr über wasser halten .	der anhaltenden kundenflaute	other
mag sein , das ihr konzept nicht aufging . die exklusiven sachen hatten ihren preis .	- es gab ja zeiten , da verkaufte sich das sehr gut .	other
ausgerechnet in der schönen weihnachtszeit offenbart sich das elend des innerstädtischen einzelhandels .	an einer ecke , die eine art aushängeschild für die stadt ist .	other
die stadt kann nur bedingt helfen ,	sie muss es endlich tun .	aber
im umgang mit hilfesuchenden händlern muss der grundsatz gelten - nichts ist unmöglich .	lässt sich das schlingernde city-schiff vielleicht doch noch auf einen erfolgversprechenden kurs bringen .	so
erstens : die parkgebühren in der einkaufszone müssen weg .	die stadt kann nur bedingt helfen , aber sie muss es endlich tun .	other
zweitens : ein anziehender branchenmix muss her - wo es die stadt nicht selbst in der hand hat , muss sie es mehr fordern , notfalls den eigentümern geeignete gewerbliche mieter selbst vermitteln .	erstens : die parkgebühren in der einkaufszone müssen weg .	other
zweitens : ein anziehender branchenmix muss her - wo es die stadt nicht selbst in der hand hat , muss sie es mehr fordern , notfalls den eigentümern geeignete gewerbliche mieter selbst vermitteln .	drittens : im umgang mit hilfesuchenden händlern muss der grundsatz gelten - nichts ist unmöglich .	other
die berliner pds lässt sich bei den koalitionsverhandlungen mit der regierenden spd in puncto flughafenausbau in schönefeld alles offen	im wahlkampf ein klares nein verkündet wurde .	other
alle politiker lügen , könnte man sagen .	sie die macht riechen ,	other
aha , alle politiker lügen , sobald sie die macht riechen , könnte man sagen .	natürlich ist es so , dass kompromisse machen muss , wer in einer koalition mitregieren will .	und
und natürlich ist es so , dass kompromisse machen muss , wer in einer koalition mitregieren will .	es kommt darauf an , wie wichtig die sache ist , in der man nachgibt .	other
es kommt allerdings darauf an , wie wichtig die sache ist , in der man nachgibt .	an der flughafen-frage hängt schon viel glaubwürdigkeit der pds .	und
und an der flughafen-frage hängt schon viel glaubwürdigkeit der pds .	die gemäßigte reaktion der parteibasis lässt noch eine andere vermutung zu :	aber
gysi will die chance der pds zum mitregieren in der bundeshauptstadt nicht für etwas vertun , was sich in einem jahr womöglich von allein erledigt .	dass der flughafenausbau in der ursprünglich vom bund und von den ländern berlin und brandenburg geplanten dimension noch zum tragen kommt , das glauben wohl nur noch die wenigsten - geschweige denn ein jurist wie gysi .	denn
war sie richtig .	diese taktik aufgeht ,	wenn
lediglich in pritzwalk hatte die möglichkeit eines zweiten wahlgangs bestanden ,	sie schien angesichts dreier kandidaten nicht unbedingt unwahrscheinlich .	auch
lediglich in pritzwalk hatte die möglichkeit eines zweiten wahlgangs bestanden , sie schien angesichts dreier kandidaten auch nicht unbedingt unwahrscheinlich .	die dömnitzstädter setzten nicht auf wechsel , bescherten wolfgang brockmann einen großartigen erfolg und sorgten für klare verhältnisse .	doch
setzten nicht auf wechsel , bescherten wolfgang brockmann einen großartigen erfolg	sorgten für klare verhältnisse .	und
die bürger zwar kontinuität wollten ,	mit einem simplen " weiter so " eben nicht einverstanden wären .	other
das kann bedeuten , dass die bürger zwar kontinuität wollten , aber mit einem simplen " weiter so " eben nicht einverstanden wären .	hat auch zigan sich acht weitere jahre im amt gesichert , die er nach eigenem bekunden auch voll erfüllen will .	other
angesichts dessen aber hat sich der junge herausforderer thomas domres gegen bürgermeister dietmar zigan durchaus achtbar geschlagen .	mit denen war in perleberg sowieso zu rechnen .	other
containerplätze sind zweckmäßig ,	leider funktionieren sie nicht so richtig .	doch
das ist bei anderen einrichtungen auch der fall , die auf selbstdisziplin und bürgersinn bauen .	viele menschen schaffen es nicht , ihren müll korrekt in die doch einfach gekennzeichneten behälter zu werfen .	other
auch bei der farbunterscheidung von flaschen haben einige zeitgenossen offensichtlich ihre probleme .	so gehen kunststoff und glas oft durcheinander ,	auch
viele menschen schaffen es nämlich nicht , ihren müll korrekt in die doch einfach gekennzeichneten behälter zu werfen .	gehen kunststoff und glas oft durcheinander , auch bei der farbunterscheidung von flaschen haben einige zeitgenossen offensichtlich ihre probleme .	so
egal , ob nun mutwillig oder aus unwissenheit - ersteres ist moralisch sicherlich verwerflicher - rund die hälfte der abfälle gerät in den falschen kreislauf . schmuddelige containerplätze sollen so bald der vergangenheit angehören .	ist es nur logisch , dass die rethmänner jetzt so nach und nach das sammelsystem umstellen .	other
da ist es nur logisch , dass die rethmänner jetzt so nach und nach das sammelsystem umstellen . schmuddelige containerplätze sollen so bald der vergangenheit angehören .	unverständlich ist die mit 37 prozent doch recht hohe anzahl der bürger vom görden , sich dem neuen system - gelbe säcke und papiertonnen - zu versagen .	deshalb
sie sollten ihre entscheidung noch einmal überdenken ,	neben dem effekt , dass die schmuddelecken verschwinden , ist der weg mit dem gelben sack vor die haustür kürzer als die fahrt zum container .	denn
der bus würde straßen im wohnviertel durchfahren .	das angebot , nahe der haustür den personennahverkehr nutzen zu können , wollen nicht alle .	doch
er gefährde spielende kinder	ließe kaffeetische wackeln .	und
die ablehnung hat in der verwaltung eine gewisse verwunderung hervorgerufen .	auf eine ansiedlung von etwa 3000 menschen sollte eine vernünftige kommunalpolitik mit einem attraktiven verkehrsangebot reagieren .	denn
denn auf eine ansiedlung von etwa 3000 menschen sollte eine vernünftige kommunalpolitik mit einem attraktiven verkehrsangebot reagieren .	hatte der bauherr vor jahren bei verkauf und vermietung der häuser eine busanbindung versprochen .	other
die zwar ihre wohnung in berlin verließen ,	dort nach wie vor arbeiten und daher täglich fahren .	other
dort aber nach wie vor arbeiten	daher täglich fahren .	und
außerdem hatte der bauherr vor jahren bei verkauf und vermietung der häuser eine busanbindung versprochen .	handelte es sich vornehmlich um bürger , die zwar ihre wohnung in berlin verließen , dort aber nach wie vor arbeiten und daher täglich fahren .	doch
dort aber nach wie vor arbeiten	und täglich fahren .	other
die verwaltung hat inzwischen beschwichtigend wissen lassen , nicht gegen den willen der bewohner zu handeln .	sind 80 unterschriften der wille der bewohner ?	doch
die ablehnung hat in der verwaltung eine gewisse verwunderung hervorgerufen . denn auf eine ansiedlung von etwa 3000 menschen sollte eine vernünftige kommunalpolitik mit einem attraktiven verkehrsangebot reagieren . außerdem hatte der bauherr vor jahren bei verkauf und vermietung der häuser eine busanbindung versprochen . handelte es sich doch vornehmlich um bürger , die zwar ihre wohnung in berlin verließen , dort aber nach wie vor arbeiten und daher täglich fahren .	die verwaltung hat beschwichtigend wissen lassen , nicht gegen den willen der bewohner zu handeln .	other
am sonnabend hetzten nicht wenige noch von geschäft zu geschäft ,	die letzten einkäufe zu erledigen .	other
manchem schien erst jetzt eingefallen zu sein , dass man am heutigen heiligen abend seinen lieben etwas schenken könnte .	nicht nur wegen solcher vergesslichkeit werden auch heute abend wieder viele menschen ohne eine liebesgabe auskommen müssen .	doch
vielleicht halten solche gedanken auch wach ,	man nicht verpasst zu helfen ,	other
vielleicht halten solche gedanken auch wach , damit man nicht verpasst zu helfen ,	sich die gelegenheit dazu bietet .	wenn
die erinnerung an diese verlierer unserer zeit sollte niemandem sein weihnachtsfest vermiesen .	ganz im gegenteil : vielleicht machen ein paar gedanken an diejenigen , die es heute nicht so gut haben , einem das eigene glück ja noch deutlicher bewusst .	other
den hut von marlowe , die pfeife von maigret oder das strickzeug von miss marple kennt detektiv t. aus hennigsdorf vom schmökern .	er hat aus den krimis , die mit der wirklichkeit so viel zu tun haben wie der traum von der gerechtigkeit mit dem realen leben , viel gelernt .	und
sei das aushorchen unseligen angedenkens nicht damit vergleichbar .	den detektiv immer ein tatbestand zum handeln fordere ,	other
habe er zwischen den zeilen gelesen	sei dabei auf etwas ganz wichtiges gestoßen .	und
während den detektiv immer ein tatbestand zum handeln fordere , sei das aushorchen unseligen angedenkens nicht damit vergleichbar .	doch macht der junge mann auch keinen schmus darum , dass er natürlich auch mal ein bisschen lavieren müsse , um an informationen zu kommen , die verwicklungen aufhellen oder menschen gewissheit geben , die schwarze schafe entweder kräftig abseifen oder einsicht wecken .	und
und doch macht der junge mann auch keinen schmus darum , dass er natürlich auch mal ein bisschen lavieren müsse , um an informationen zu kommen , die verwicklungen aufhellen oder menschen gewissheit geben , die schwarze schafe entweder kräftig abseifen oder einsicht wecken .	im unterschied zu detektiven der bekannteren prägung hat t. keine rechte , die ihm bei ermittlungen helfen .	other
die verwicklungen aufhellen	menschen gewissheit geben ,	oder
die schwarze schafe entweder kräftig abseifen	einsicht wecken .	oder
im unterschied zu detektiven der bekannteren prägung nämlich hat t. keine rechte , die ihm bei ermittlungen helfen .	eines hat er mit seinen berühmten kollegen gemein .	aber
und er hat aus den krimis , die mit der wirklichkeit so viel zu tun haben wie der traum von der gerechtigkeit mit dem realen leben , viel gelernt .	vor allem , sagt er mit augenzwinkern , habe er zwischen den zeilen gelesen und sei dabei auf etwas ganz wichtiges gestoßen .	other
auch t. arbeitet in diesem spannungsfeld .	gute krimis sind immer ein spiegelbild der probleme gesellschaft gewesen .	auch
amerikaner würden sich bei dieser frage wahrscheinlich auf den boden werfen	lauthals lachen :	und
kinder und jugendliche sport treiben	dabei kräftig atmen ?	und
ungehemmtes qualmen und paffen überall ,	oft schlägt einem nichtraucher sogar noch aggression entgegen , weist er freundlich darauf hin , dass es unerträglich müffelt ...	und
ungehemmtes qualmen und paffen überall , und oft schlägt einem nichtraucher sogar noch aggression entgegen , weist er freundlich darauf hin , dass es unerträglich müffelt ...	ist die beharrlichkeit zu loben , mit der die falkenseer stadtverwaltung einer berliner musikgruppe die konzerterlaubnis für die stadthalle - quasi eine der letzten rauchfreien bastionen - eben nicht erteilt .	other
wer ernsthaft über jugendschutz redet ( stichwort suchtgefahren ) , der sollte kleine leute nicht an einen ort zum bodenturnen schicken , in dem es riecht wie in einer kneipe am morgen nach der weihnachtsfeier .	es übertrieben klingen mag :	other
und deutschland ?	schon der gedanke daran wäre undenkbar in einem land , in dem der nikotinkonsum in öffentlichen gebäuden , auf flughäfen und auch in restaurants ( sogar an tischen im freien mitten in manhattan ! ) unter strafe steht .	und
lange hat sich die europäische zentralbank gesträubt .	gestern hat sie auf die schwache konjunktur mit einer kräftigen leitzinssenkung um 0,5 prozentpunkte auf 3,25 prozent reagiert .	doch
- dass die weltwirtschaft in eine schwere krise rutscht , bestreitet niemand mehr .	sich ezb-chef wim duisenberg weiter weigert , das böse r-wort " rezession " in den mund zu nehmen	other
auch wenn sich ezb-chef wim duisenberg weiter weigert , das böse r-wort " rezession " in den mund zu nehmen - dass die weltwirtschaft in eine schwere krise rutscht , bestreitet niemand mehr .	fraglich ist , ob niedrige zinsen und damit billigeres geld für mehr investitionen und konsum und so für den erhofften raschen aufschwung sorgen .	aber
fraglich ist aber , ob niedrige zinsen und damit billigeres geld für mehr investitionen und konsum	so für den erhofften raschen aufschwung sorgen .	und
die verunsicherung von verbrauchern und unternehmern ist seit dem 11. september weniger ökonomisch als psychologisch begründet .	wirkt geldpolitik erfahrungsgemäß erst nach einem jahr .	other
lange hat sich die europäische zentralbank gesträubt . doch gestern hat sie auf die schwache konjunktur mit einer kräftigen leitzinssenkung um 0,5 prozentpunkte auf 3,25 prozent reagiert . auch wenn sich ezb-chef wim duisenberg weiter weigert , das böse r-wort " rezession " in den mund zu nehmen - dass die weltwirtschaft in eine schwere krise rutscht , bestreitet niemand mehr . fraglich ist aber , ob niedrige zinsen und damit billigeres geld für mehr investitionen und konsum und so für den erhofften raschen aufschwung sorgen . die verunsicherung von verbrauchern und unternehmern ist seit dem 11. september weniger ökonomisch als psychologisch begründet . außerdem wirkt geldpolitik erfahrungsgemäß erst nach einem jahr .	die wichtigste botschaft der zinsentscheidung ist eine andere :	deshalb
die währungshüter haben ihren teil getan , jetzt können die politiker nicht mehr die verantwortung abschieben ,	müssen selbst mit ihren mitteln aktiv werden .	sondern
war klar : da fehlt noch was .	1999 die im rahmen der dorferneuerung neu gestaltete radeweger ablage inklusive seebrücke mit viel pomp eingeweiht wurde ,	als
sanitäre anlagen gehören heute zum standard großer liegeplätze .	mit der nachrüstung tut sich radewege schwer .	doch
beschlüsse zu überdenken ist legitim ,	nur von alternativen zu reden , ohne brauchbare vorschläge auf den tisch zu legen , ist zu billig .	doch
nur von alternativen zu reden , ist zu billig .	brauchbare vorschläge auf den tisch zu legen ,	other
ein multifunktionales objekt mit umkleide- und treffmöglichkeiten als angeblich bessere variante ist bisher nicht mehr als eine fiktive idee geblieben . und ob diese billiger wird , steht auf einem anderen blatt .	hat radewege mit dem nicht weit entfernten haus des beetzseetreffs e. v. ein gebäude , das vielen freizeitbedürfnissen gerecht werden kann .	other
ein multifunktionales objekt mit umkleide- und treffmöglichkeiten als angeblich bessere variante ist bisher nicht mehr als eine fiktive idee geblieben .	ob diese billiger wird , steht auf einem anderen blatt .	und
kommt der sanitärtrakt nicht spätestens zur nächsten saison , droht radewege , den wettbewerb um freizeitkapitäne auf dem beetzsee mit anderen anbietern zu verlieren .	hätte das dorf jede einnahme nötig .	other
es herrscht kein wohnungsnotstand in wusterhausen .	war sich die gemeindevertretung sicher , dass man ein neues wohngebiet ausweisen müsse .	other
dennoch war sich die gemeindevertretung sicher , dass man ein neues wohngebiet ausweisen müsse .	was nach der idee kam , ging erstaunlich schnell .	dann
das wird auch notwendig sein ,	die gemeinde ist erst einmal mit 1,2 millionen mark in vorleistung gegangen .	denn
kriegen sie leichter appetit , so die hoffnung .	die leute übersichtlich angeboten bekommen , was sie mal selber nutzen können ,	wenn
wenn die leute übersichtlich angeboten bekommen , was sie mal selber nutzen können , kriegen sie leichter appetit , so die hoffnung .	das wird notwendig sein , denn die gemeinde ist erst einmal mit 1,2 millionen mark in vorleistung gegangen .	auch
jungen familien das hierbleiben lukrativ zu machen	somit einer pflicht nachzukommen , die jede kommune hat	und
besonders jungen familien das hierbleiben lukrativ zu machen	und einer pflicht nachzukommen , die jede kommune hat	other
in wusterhausen erhöht es sich noch ,	man auch im nahen bantikow bauplätze findet ,	weil
in wusterhausen erhöht es sich noch , weil man auch im nahen bantikow bauplätze findet , wenngleich nicht zu diesem preis .	haben die gemeindevertreter mut gezeigt .	also
weil man auch im nahen bantikow bauplätze findet ,	nicht zu diesem preis .	other
nicht einmal ein jahr ist seit fassen des aufstellungsbeschlusses und beginn der erschließungsarbeiten vergangen .	demnächst wird man schon trockenen fußes voll erschlossene parzellen in augenschein nehmen können .	other
fuß zu fassen	dauerhaft präsenz zu zeigen ?	und
wie ernst ist vor diesem hintergrund ein tourismusverband havelland zu nehmen , dem es nicht gelingt , in seinem schon wegen der nähe zur hauptstadt nicht unattraktiven östlichen teil fuß zu fassen und dauerhaft präsenz zu zeigen ?	die verantwortlichen im falkenseer rathaus müssen sich fragen lassen , ob es nicht doch sinnvoll wäre , im haushalt mehr geld als bisher für diese belange aufzutreiben , zumal ja ein sündhaft teures " touristik-konzept " bereits vorhanden ist .	other
ob es nicht doch sinnvoll wäre , im haushalt mehr geld als bisher für diese belange aufzutreiben ,	ja ein sündhaft teures " touristik-konzept " bereits vorhanden ist .	other
aber andererseits hängt erfolg immer auch von image und von selbstbewusstsein ab -	bescheidene werbung ist besser als keine .	other
bescheidene werbung ist zwar besser als keine .	aber hängt erfolg immer auch von image und von selbstbewusstsein ab -	other
stadt und tourismusverband konnten sich nicht auf einen finanziellen kompromiss verständigen .	und nun ?	other
im august dieses jahres entlud sich auf einer einwohnerversammlung der zorn der klosteraner in der ankündigung , den bau der neuen bundesstraße und der ortsumgehung jüterbog zu stoppen .	seit gestern graben sich am östlichen rand jüterbogs die baumaschinen ins erdreich .	aber
die trasse ist abgesteckt , und die führt nicht um kloster herum , sondern eher direkt in den ort hinein .	klar , dass es gestern beim ersten spatenstich nicht nur fröhliche mienen und gute worte gab .	also
die trasse ist abgesteckt ,	die führt nicht um kloster herum ,	und
Übrigens auch nicht nur bei den anwesenden leuten der kloster zinnaer bürgerinitiative ,	zum beispiel auch bei jüterbogs vorkämpferin für eine verkehrsberuhigung in innenstadt und schloßstraße .	sondern
Übrigens auch nicht nur bei den anwesenden leuten der kloster zinnaer bürgerinitiative ,	sondern auch bei jüterbogs vorkämpferin für eine verkehrsberuhigung in innenstadt und schloßstraße .	other
der euphorischen stimmung tat das keinen abbruch .	eher fröhlich vertröstete minister meyer die klosteraner erneut auf den nächsten bundesverkehrswegeplan .	other
eher fröhlich vertröstete minister meyer die klosteraner erneut auf den nächsten bundesverkehrswegeplan .	vor 2006 sei da nichts drin .	other
vor 2006 sei da nichts drin .	eher süß-sauer die mienen der klosteraner .	other
muss pritzerbe mit seiner favoritenrolle klarkommen .	eine anbindung der rathenower region über milow als unwahrscheinlich gilt und die döberitzer variante aus gründen des naturschutzes abwegig ist	other
eine anbindung der rathenower region über milow als unwahrscheinlich gilt	die döberitzer variante aus gründen des naturschutzes abwegig ist	und
diplomatisches geschick und politischer weitblick sind gefragt ,	es um die verhandlungsmasse geht .	wenn
positive effekte einer havelbrücke lassen sich für pritzerbe gar nicht abschätzen . ein gewerbeboom ist kaum zu erwarten .	könnte die region vom wirtschaftsstandort premnitz/rathenow mit arbeitsplätzen profitieren - wenn er denn überhaupt kommt , der aufschwung , den havelländische firmen vom a_2-zubringer abhängig machen .	other
dafür könnte die region vom wirtschaftsstandort premnitz/rathenow mit arbeitsplätzen profitieren	- er denn überhaupt kommt , der aufschwung , den havelländische firmen vom a_2-zubringer abhängig machen .	wenn
gestern begann das raumordnungsverfahren für die autobahntrasse zur a2 .	ab heute kann jeder interessierte die unterlagen vier wochen in den Ämtern einsehen .	other
jährlich stattfinden	in größerem abstand ?	oder
so einfach die frage ist ,	so laufen die beteiligten gefahr , sich vor gericht zu treffen .	doch
das fest , das tausende besucher anlockt , hat es nicht verdient , als zankapfel herzuhalten .	alle beteiligten ehrenwerte ziele verfolgen .	other
der verein brandenburger vorstadt plädiert für ein fest von bürgern für bürger .	ein gutes konzept , das sich - da rein ehrenamtlich - nur in größeren abständen verwirklichen lässt .	aber
der aktionskreis um martin zühlke zieht die grenzen lockerer	votiert für jährliche termine .	und
das hausrecht für den stadtteil hat er nicht .	der verein hat rechte am namen von " affe , schaf und känguru " ,	other
sollten sie die auch entscheiden lassen :	sich beide seiten auf die bürger berufen ,	other
soll die neue straße an der parforceheide durch buckel ergänzt werden , die den steuerzahler 40_000 mark kosten .	es rund um die plattenbauten an allen ecken hapert , dem schlaatz gerade mittel entzogen werden müssen ,	other
während es rund um die plattenbauten an allen ecken hapert , dem schlaatz gerade mittel entzogen werden müssen , soll die neue straße an der parforceheide durch buckel ergänzt werden , die den steuerzahler 40_000 mark kosten .	sind es vor allem anwohner , die mit mehr als den erlaubten 7 km/h durch die ausgewiesene spielstraße fahren .	other
hier , wo sich die namensschilder wie ein potsdamer " who is who ? " kluger menschen lesen ,	ist man offenbar nicht in der lage , miteinander zu reden und eine lösung zu finden .	aber
die stadt wäre gut beraten , sich diesem moralischen imperativ nicht zu beugen .	müsste sie vor jeder schule und jeder kita bremsbuckel aufpflastern .	other
das wäre vielleicht wünschenswert ,	aber unbezahlbar .	other
lieber gründet man bürgerbewegung und antibewegung ,	die buckelgegner öffentlich als kinderfeindlich gebrandmarkt werden .	other
in welchem elend andere menschen leben , wie sie hungern , keine kleidung haben	ein kinderkrankenhaus einfach ohne lebensmittel dasteht	oder
verkehrsgesellschaften , krankenhaus-gmbh oder abfallwirtschaftsbetrieb stehen außerhalb der kritik , diese unternehmen erledigen aufgaben der daseinsvorsorge .	dass etwa bei der abu-service-gmbh oder nun auch bei der gesundheitszentrum-gmbh der zunächst gut gemeinte soziale zweck alle mittel der geschäftlichen betätigung heiligen soll , ist nicht nachvollziehbar	aber
erst recht nicht ,	sich der verdacht bestätigt , dass der kreis potsdam-mittelmark so verantwortungslos wie in der anonymen anzeige geschildert mit steuergeld und gebühreneinnahmen umgeht .	wenn
sie wurden ignoriert .	verkehrsgesellschaften , krankenhaus-gmbh oder abfallwirtschaftsbetrieb stehen außerhalb der kritik , diese unternehmen erledigen aufgaben der daseinsvorsorge .	other
dass aber etwa bei der abu-service-gmbh oder nun auch bei der gesundheitszentrum-gmbh der zunächst gut gemeinte soziale zweck alle mittel der geschäftlichen betätigung heiligen soll , ist nicht nachvollziehbar .	erst recht nicht , wenn sich der verdacht bestätigt , dass der kreis potsdam-mittelmark so verantwortungslos wie in der anonymen anzeige geschildert mit steuergeld und gebühreneinnahmen umgeht .	other
derzeit will jeder fachausschuss die eigenen finanziellen interessen sichern -	eigenmittel für investitionen oder zuschüsse für betriebs- und unterhaltskosten von einrichtungen freier träger .	other
derzeit will jeder fachausschuss die eigenen finanziellen interessen sichern - zum beispiel eigenmittel für investitionen oder zuschüsse für betriebs- und unterhaltskosten von einrichtungen freier träger . ohne rotstift wird wohl die rechnerei nicht aufgehen .	muss der haushalt ausgeglichen sein .	other
andererseits muss der haushalt ausgeglichen sein . ohne rotstift wird wohl die rechnerei nicht aufgehen .	kein wunder , dass jetzt jeder einzelne haushaltsposten auf den prüfstand kommt .	also
kein wunder also , dass jetzt jeder einzelne haushaltsposten auf den prüfstand kommt .	für das kaum öffentlich gemachte thema der sozialfürsorgepflicht der kommune kann keine schranke gelten .	auch
die obdachlosen wittstocker kamen nach heinrichsfelde und müssen demnächst nach kyritz ziehen . geld an den betreiber der unterkünfte zu zahlen , ist für die stadt billiger .	die soziale lage der betroffenen ändert sich bei diesem rechenbeispiel nicht .	aber
die obdachlosen wittstocker kamen nach heinrichsfelde geld an den betreiber der unterkünfte zu zahlen , ist für die stadt billiger .	müssen demnächst nach kyritz ziehen .	und
die frage stellt sich , ob nicht die randgruppe der obdachlosen auch mit dem neuen quartier in kyritz weiter auf das abstellgleich geschoben werden .	eigentlich sind sie ja in wittstock zu hause .	denn
auch für das kaum öffentlich gemachte thema der sozialfürsorgepflicht der kommune kann keine schranke gelten .	vom eigenen obdachlosenheim hat sich die stadt vor über einem jahr getrennt .	other
am liebsten würde die feuerwehr ja schon in fünf minuten an jedem ort der stadt sein ,	derzeit sind es bestenfalls acht .	aber
rechnet man noch fünf minuten drauf zwischen alarm und start , kommen die retter schon an ihre grenzen : ab 18 minuten kommt für menschen in einer verqualmten wohnung jede hilfe zu spät .	kann es für die feuerwehr beim wegzug aus der seelenbinderstraße nur einen maßstab geben : schnelligkeit .	also
also kann es für die feuerwehr beim wegzug aus der seelenbinderstraße nur einen maßstab geben : schnelligkeit .	die scheint nur bei zwei standorten an der berliner straße garantiert : nahe der schnellstraße wäre man hier , nahe am klinikum und nahe am wasser - auch dort will man helfen können .	aber
mag er in zwei punkten recht haben : zwischen berliner straße und der havel kann man prima wohnungen bauen , und das wasserbetriebsgelände harrt einer besseren nutzung .	nun der cdu-abgeordnete peter lehmann das wasserwirtschaftsareal an der friedrich-engels-straße für die feuerwache potsdam fordert ,	wenn
zwischen berliner straße und der havel kann man prima wohnungen bauen ,	das wasserbetriebsgelände harrt einer besseren nutzung .	und
wenn nun der cdu-abgeordnete peter lehmann das wasserwirtschaftsareal an der friedrich-engels-straße für die feuerwache potsdam fordert , mag er in zwei punkten recht haben : zwischen berliner straße und der havel kann man prima wohnungen bauen , und das wasserbetriebsgelände harrt einer besseren nutzung .	wie die einsatzfahrzeuge von der friedrich-engels-straße aus das dauerproblem bau und stau auf der langen brücke umfahren sollen , das sagt er nicht .	aber
wie aber die einsatzfahrzeuge von der friedrich-engels-straße aus das dauerproblem bau und stau auf der langen brücke umfahren sollen , das sagt er nicht .	kann die neue wache - zumal bereits eine berufswache in babelsberg besteht - nur nördlich der havel liegen .	other
mithin kann die neue wache - nur nördlich der havel liegen .	bereits eine berufswache in babelsberg besteht -	other
am liebsten würde die feuerwehr ja schon in fünf minuten an jedem ort der stadt sein , aber derzeit sind es bestenfalls acht .	rechnet man noch fünf minuten drauf zwischen alarm und start , kommen die retter schon an ihre grenzen :	other
der wunsch nach frieden wächst in zeiten des krieges . erst recht ,	der krieg dem eigenen land gefährlich nahe rückt .	wenn
afghanistan ist für deutsche soldaten näher , als es viele wahrhaben wollen .	dem vom bundestag abgesegneten bündnis-marschbefehl	other
zu weit klafft die schere zwischen arm und reich auseinander . sozialer sprengstoff , der unmenschen wie bin laden stark und unberechenbar gemacht hat . das haben die anschläge vom 11. september gezeigt .	heiligt der kampf gegen den top-terroristen und seine helfer jedes kriegerische mittel ?	aber
die geburt war denkbar schwer ,	jetzt hat das kind sogar schon einen namen : ein " humboldt-forum " soll anstelle des einstigen berliner stadtschlosses entstehen .	doch
das forum soll die fassade und die dimensionen des 1950 gesprengten schlosses erhalten	die berliner landesbibliothek , museen und konzertsäle aufnehmen .	und
es ist ja richtig , über diese dinge zu streiten ,	welche andere hauptstadt würde es sich leisten , ausufernden grundsatzdebatten zuliebe ihre " gute stube " für zehn jahre dem unkraut zu überlassen ?	doch
mit ihrer entscheidungsschwäche in sachen schloss hat sich die berliner stadtpolitik ein armutszeugnis ausgestellt .	jetzt ist die zeit des diskutierens abgelaufen - wichtig ist , dass endlich etwas passiert .	other
gleich am ersten tag nach ihrem wahlsieg kam - - der eu-kommissar für regionalpolitik aus brüssel ,	als ob es so geplant gewesen wäre	so
gleich am ersten tag nach ihrem wahlsieg kam - so als ob es so geplant gewesen wäre - der eu-kommissar für regionalpolitik aus brüssel ,	hier mit vertretern der letzten drei deutschen urban-städte die programm-verträge unterzeichnen .	other
natürlich war es so nicht geplant gewesen ,	ein rein zufälliges zusammentreffen zweier für luckenwalde bedeutsamer ereignisse , an denen elisabeth herzog nicht unbeteiligt war .	sondern
dass luckenwalde als kleinste von insgesamt zwölf deutschen städten vom urban-ii-projekt profitiert , ist ganz wesentlich der 2. beigeordneten und künftigen bürgermeisterin zu verdanken ,	was ihr im wahlkampf sicherlich geholfen hat .	auch
dass luckenwalde als kleinste von insgesamt zwölf deutschen städten vom urban-ii-projekt profitiert , ist ganz wesentlich der 2. beigeordneten und künftigen bürgermeisterin zu verdanken , was ihr im wahlkampf sicherlich auch geholfen hat .	brandenburgs städtebauminister hartmut meyer meinte auch gestern : " es ist ein guter start , wenn man gleich am ersten tag 38 millionen mark bekommt . wenn das so weiter geht ... "	dann
" es ist ein guter start ,	man gleich am ersten tag 38 millionen mark bekommt . wenn das so weiter geht ... "	wenn
natürlich geht es nicht so weiter , jedenfalls nicht tag für tag .	nach all den vorschusslorbeeren meinte minister meyer dann auch zur künftigen bürgermeisterin : " jetzt werden sie erst einmal an ihren taten gemessen . "	und
und nach all den vorschusslorbeeren	meinte minister meyer auch zur künftigen bürgermeisterin : " jetzt werden sie erst einmal an ihren taten gemessen . "	dann
während der vergangenen monate - waren sie selten daheim anzutreffen , die landwirte und wiedereinrichter . in der erntezeit wird eben jede schönwetterstunde bis zur letzten minute ausgenutzt . ganz gleich , ob Ähren vom halm oder kartoffeln aus dem boden zu holen sind .	das gilt auch für die wochenenden -	und
während der vergangenen monate - und das gilt auch für die wochenenden - waren sie selten daheim anzutreffen , die landwirte und wiedereinrichter . in der erntezeit wird eben jede schönwetterstunde bis zur letzten minute ausgenutzt . ganz gleich , ob Ähren vom halm oder kartoffeln aus dem boden zu holen sind . " da " , so heißt es in diesen tagen , " haben wir schon ganz andere jahre erlebt . " wer die arbeit dieser frauen und männer übers jahr verfolgt , versteht , warum sie sich trotz vieler mühen das erntefest nie entgehen lassen . es ist nicht nur ein alter brauch . es ist zugleich eine bühne , auf der sich mit berechtigtem stolz ausrufen lässt : seht her , was mensch , tier und technik der natur abgerungen haben . und die freude in den gesichtern der leute , die handwagen ziehen , pferdegespanne führen oder erntemaschinen lenken , ist mindestens genau so groß wie der ehrgeiz , mit dem sie sich im kommenden jahr wieder in die arbeit stürzen . irre ich mich , oder werden es von jahr zu jahr mehr menschen , die dem lustigen landvolk winken und applaudieren ? recht so ! Ä(e)hre , wem Ä(e)hre gebührt .	auch , wenn nicht alle blütenträume gereift sind , zeigen sich die landwirte nicht unzufrieden .	und
zeigen sich die landwirte nicht unzufrieden .	auch , nicht alle blütenträume gereift sind ,	wenn
wer die arbeit dieser frauen und männer übers jahr verfolgt , versteht , warum sie sich das erntefest nie entgehen lassen .	vieler mühen	other
es ist nicht nur ein alter brauch .	es ist eine bühne , auf der sich mit berechtigtem stolz ausrufen lässt : seht her , was mensch , tier und technik der natur abgerungen haben .	other
die handwagen ziehen , pferdegespanne führen	erntemaschinen lenken , ist mindestens genau so groß wie der ehrgeiz , mit dem sie sich im kommenden jahr wieder in die arbeit stürzen	oder
irre ich mich , ? recht so ! Ä(e)hre , wem Ä(e)hre gebührt .	werden es von jahr zu jahr mehr menschen , die dem lustigen landvolk winken und applaudieren	oder
es ist zugleich eine bühne , auf der sich mit berechtigtem stolz ausrufen lässt : seht her , was mensch , tier und technik der natur abgerungen haben .	. die freude in den gesichtern der leute , die handwagen ziehen , pferdegespanne führen oder erntemaschinen lenken , ist mindestens genau so groß wie der ehrgeiz , mit dem sie sich im kommenden jahr wieder in die arbeit stürzen	und
die innenpolitische situation in deutschland hat sich grundlegend gewandelt :	den terroranschlägen in den usa	other
haben sie den ernst der lage erkannt .	die basis murrt ,	other
auch wenn die basis murrt , haben sie den ernst der lage erkannt .	die pds stellt in diesen tagen erneut unter beweis , dass sie noch immer nicht im vereinten deutschland angekommen ist .	other
oder nimmt sich selbst nicht ernst .	ist grenzenlos naiv	other
als gilde seinen rechenschaftsbericht runterspulte .	eingehen auf die eigene person	other
bleibt gilde im rennen	engel ist draußen .	und
seinen zuhörern in der aula des oberstufenzentrums kamen jedenfalls alle guten gefühle abhanden ,	gilde ohne eingehen auf die eigene person seinen rechenschaftsbericht runterspulte .	als
das war gegenüber cdu-mann wolfgang engel , der überraschend viel sicherheit ausstrahlte , eine schwache kür .	bleibt gilde im rennen und engel ist draußen .	other
ablehnung gab es nämlich nicht für den mann ,	für seinen posten , der ihn zum befürworter des bombodroms machen muss .	sondern
sich jetzt die junge union in werder scharf gegen seinen kurs wendet	ein cdu-stadtverordneter gar mit seinem sofortigen austritt aus der christlich demokratischen union droht ,	und
ein alarmsignal für schönbohm müsste es jedenfalls sein ,	sich jetzt die junge union in werder scharf gegen seinen kurs wendet und ein cdu-stadtverordneter gar mit seinem sofortigen austritt aus der christlich demokratischen union droht , weil für ihn demokratische spielregeln eklatant verletzt wurden .	wenn
wenn sich jetzt die junge union in werder scharf gegen seinen kurs wendet und ein cdu-stadtverordneter gar mit seinem sofortigen austritt aus der christlich demokratischen union droht ,	für ihn demokratische spielregeln eklatant verletzt wurden .	weil
dass er gleich zwei cdu-bürgermeister gegen sich aufgebracht hat wo sie mit sicherheit jede partei bitter nötig hat - nämlich an der basis .	damit dort ansehen und rückhalt verlieren wird ,	und
dass er gleich zwei cdu-bürgermeister gegen sich aufgebracht hat und damit dort ansehen und rückhalt verlieren wird , wo sie mit sicherheit jede partei bitter nötig hat - nämlich an der basis .	durchaus brisant wird die situation für den parteivorsitzenden auch ,	other
in werder am 24. februar ein bürgermeister gewählt wird	es bisher als sicher galt , dass cdu-amtsinhaber werner große unangefochten bleibt .	und
das muss sich nicht ändern ,	wenn der eigene parteichef dem kandidaten so derb in die parade einer erfolgreichen amtszeit fährt , werden andere parteien nicht säumen , ihre ansprüche deutlicher als bisher anzumelden .	doch
werden andere parteien nicht säumen , ihre ansprüche deutlicher als bisher anzumelden .	der eigene parteichef dem kandidaten so derb in die parade einer erfolgreichen amtszeit fährt ,	wenn
es brodelt an der cdu-basis in werder und umgebung .	der grund ist die weigerung des innenministers und parteivorsitzenden jörg schönbohm , dem eindeutigen bürgerwillen der golmer nach eingliederung in die stadt werder nachzukommen .	other
der grund ist die weigerung des innenministers und parteivorsitzenden jörg schönbohm , dem eindeutigen bürgerwillen der golmer nach eingliederung in die stadt werder nachzukommen .	ein alarmsignal für schönbohm müsste es jedenfalls sein , wenn sich jetzt die junge union in werder scharf gegen seinen kurs wendet und ein cdu-stadtverordneter gar mit seinem sofortigen austritt aus der christlich demokratischen union droht , weil für ihn demokratische spielregeln eklatant verletzt wurden .	other
von spektakulären ausbrüchen aus den gefängnissen ist justizminister schelter bislang verschont geblieben .	für seine amtszeit verbucht die justizchronik nun einen vorgang der besonderen art .	aber
schlicht durch eine namensverwechslung konnte der verurteilte dieb das gefängnistor passieren .	ist er verschwunden .	other
gefährlich sei er nicht , beeilte sich das justizministerium gestern mitzuteilen ,	- klar doch - in die freiheit gehört er auch noch nicht .	aber
da bekommt einer entlassungspapiere , nur weil er zufällig den selben nachnamen wie ein mitgefangener trägt .	hätte die frau des eigentlich zu entlassenden nicht nachgefragt , wo ihr mann eigentlich bleibt , wäre der falsche abgänger vielleicht noch immer nicht aufgefallen .	und
schlicht konnte der verurteilte dieb das gefängnistor passieren .	eine namensverwechslung	other
hauptsache die gesamtzahl stimmt ,	abends zugeschlossen wird .	wenn
luckenwalde kann bekanntlich aus den millionen des urban-projektes in den nächsten jahren einen zweckmäßigen und modernen stadtumbau gestalten .	der würde wenig nützen , wenn sich wie derzeit auch in einigen jahren immer noch die b 101 durch die stadt schlängeln würde .	doch
doch der würde wenig nützen ,	sich wie derzeit auch in einigen jahren immer noch die b 101 durch die stadt schlängeln würde .	wenn
doch der würde wenig nützen , wenn sich wie derzeit auch in einigen jahren immer noch die b 101 durch die stadt schlängeln würde .	kann es nur gut sein , wenn die ortsumgehung so schnell wie möglich fertig wird .	also
also kann es nur gut sein ,	die ortsumgehung so schnell wie möglich fertig wird .	wenn
in gut zwei jahren soll alles fertig sein .	sorgt die neue b 101 als lebensader der region nicht nur für eine schnelle anbindung an die autobahn .	dann
die ortsumgehung garantiert , dass mehr ruhe in die stadt einkehrt , luckenwalde als wohnort immer attraktiver wird .	ruhe ist keinesfalls im wirtschaftsbereich angesagt .	doch
die neue straße soll ja gerade auch investoren locken .	moderne verkehrliche infrastruktur ist auch nur als signal an die wirtschaft zu verstehen , sich hier oder dort niederzulassen .	aber
moderne verkehrliche infrastruktur ist aber auch nur als signal an die wirtschaft zu verstehen , sich hier oder dort niederzulassen .	wichtig ist vor allem , investoren überzeugend klar zu machen , warum luckenwalde für sie ein lohnenswerter standort sein kann .	other
wie schwierig es ist , in dieser region einen ausbildungsplatz zu finden , haben wir an dieser und anderer stelle oft und ausführlich bewertet .	bemühen sich unternehmen sowie die industrie- und handelskammer potsdam den schulabgängern wege in die ausbildung aufzuzeigen .	other
die vertreter der " null-bock-generation " mag es wohl geben ,	viele - wohl die meisten - wollen es mit einer lehre versuchen und sind guten willens sich bei der suche nach einem ausbildungsplatz entsprechend anzustrengen .	aber
wollen es aber mit einer lehre versuchen	sind guten willens sich bei der suche nach einem ausbildungsplatz entsprechend anzustrengen .	und
das sollte honoriert werden	möglichst viele betriebe - trotz aller wirtschaftlichen probleme , die in den nächsten zwei jahren vor der türe stehen - intensiv ausbilden .	other
das sollte honoriert werden indem möglichst viele betriebe -	aller wirtschaftlichen probleme , die in den nächsten zwei jahren vor der türe stehen - intensiv ausbilden .	other
längst ist der zeitpunkt absehbar , zu dem um lücken in unternehmen zu füllen .	gute facharbeiter ins land geholt werden müssen ,	other
das wäre überflüssig ,	deutsche fachkräfte jetzt ausgebildet werden .	wenn
deutschland steht am rande einer rezession ,	die aussichten werden immer düsterer .	und
schon im zweiten quartal des laufenden jahres hat sich die wirtschaft nicht mehr bewegt .	für das dritte quartal , dessen ergebnisse heute vorgestellt werden , ist nicht mit einem wiederanziehen des wachstums zu rechnen .	auch
zu diesen eher objektiven zahlen kommen nun die subjektiven - die individuellen erwartungen .	da sieht es immer schlechter aus .	und
und da sieht es immer schlechter aus .	inzwischen haben auch die unternehmer den mut verloren .	denn
nach dem münchener geschäftsklima-index beurteilen sie die aussichten der nächsten sechs monate schlechter als noch im september .	wirtschaft basiert auf vertrauen .	aber
das ist alarmierend ,	sich auch der im ersten halbjahr noch starke private konsum abgeschwächt hat .	other
zumal sich auch der im ersten halbjahr noch starke private konsum abgeschwächt hat .	ist der export eingebrochen , der traditionell die deutsche konjunktur beflügelt hat .	other
angenommen , nur mal angenommen , der cdu-landesvorsitzende s. im land b. hätte sich für edmund stoiber als kanzlerkandidaten der union entschieden . nehmen wir weiter an , dass die cdu-basis im bundesland b. eher ihrer parteichefin angela merkel zuneigt ,	dürfte landeschef s. guten gewissens im cdu-bundesvorstand für stoiber votieren ?	dann
erst spielen die dallgower gemeindevertreter so statisch und verzagt wie die deutsche abwehrreihe der fußballkicker .	dann kommt aus der tiefe solch ein fulminanter steilpass , von dem man hofft , dass die seeburger oder groß-glienicker mitspieler ihn aufnehmen können .	und
erst spielen die dallgower gemeindevertreter so statisch und verzagt wie die deutsche abwehrreihe der fußballkicker .	und kommt aus der tiefe solch ein fulminanter steilpass , von dem man hofft , dass die seeburger oder groß-glienicker mitspieler ihn aufnehmen können .	dann
den ball erst zurückgespielt	und um so drängender wieder gefordert .	dann
und dann kommt aus der tiefe solch ein fulminanter steilpass , von dem man hofft , dass die seeburger oder groß-glienicker mitspieler ihn aufnehmen können .	ein befreiungsschlag ist es nicht , weil es vorerst keine gefahr fürs dallgower tor gab .	other
ein befreiungsschlag ist es allerdings nicht ,	es vorerst keine gefahr fürs dallgower tor gab .	weil
die seeburger und einige groß-glienicker haben den ball erst zurückgespielt	dann um so drängender wieder gefordert .	und
eine diskussion , wo künftig die trainerkabine stehen soll , wäre in der jetzigen spielsituation verheerend .	eine parallele zu den deutschen grotten-kickern gibt es immer noch .	und
sie müssen sich daran gewöhnen , dass sie nun in einer mannschaft " döberitzer heide " spielen .	die spieler aus den verschiedenen vereinen zusammengewürfelt sind ,	other
ermahnungen von der seitenlinie , miteinander fair umzugehen und sich nicht beim kleinsten schubser gegenseitig zu zerfleischen , sind normalerweise überflüssig .	vorerst hilfreich .	other
sie müssen sich daran gewöhnen , dass sie nun in einer mannschaft " döberitzer heide " spielen .	das heißt gemeinsam und nicht gegeneinander .	und
die seeburger und einige groß-glienicker haben den ball erst zurückgespielt und dann um so drängender wieder gefordert .	nun sollen sie zeigen , wie sie die chance verwerten .	other
